"a" = (/turf/template_noop,/area/template_noop)
"b" = (/turf/closed/wall/shuttle/smooth{baseturf = /turf/open/floor/plating/lava/smooth},/area/ruin/powered)
"c" = (/obj/machinery/smartfridge,/turf/open/floor/plasteel/freezer{baseturf = /turf/open/floor/plating/lava/smooth},/area/ruin/powered)
"d" = (/obj/structure/closet/crate/hydroponics,/obj/item/weapon/cultivator,/obj/item/weapon/cultivator,/obj/item/weapon/cultivator,/obj/item/weapon/cultivator,/obj/item/weapon/shovel/spade,/obj/item/weapon/shovel/spade,/obj/item/weapon/shovel/spade,/obj/item/weapon/shovel/spade,/obj/item/weapon/hatchet,/obj/item/weapon/hatchet,/obj/item/weapon/hatchet,/obj/item/weapon/hatchet,/turf/open/floor/plasteel/freezer{baseturf = /turf/open/floor/plating/lava/smooth},/area/ruin/powered)
"e" = (/obj/machinery/hydroponics/constructable,/turf/open/floor/plasteel/freezer{baseturf = /turf/open/floor/plating/lava/smooth},/area/ruin/powered)
"f" = (/obj/structure/closet/crate,/obj/effect/spawner/lootdrop/seed_vault,/turf/open/floor/plasteel/freezer{baseturf = /turf/open/floor/plating/lava/smooth},/area/ruin/powered)
"g" = (/obj/machinery/plantgenes/seedvault,/turf/open/floor/plasteel/freezer{baseturf = /turf/open/floor/plating/lava/smooth},/area/ruin/powered)
"h" = (/obj/item/weapon/hatchet,/obj/item/weapon/storage/bag/plants,/obj/item/weapon/reagent_containers/glass/bucket,/turf/open/floor/plasteel/freezer{baseturf = /turf/open/floor/plating/lava/smooth},/area/ruin/powered)
"i" = (/obj/structure/table/wood,/obj/item/weapon/storage/bag/plants,/obj/item/weapon/storage/bag/plants,/obj/item/weapon/storage/bag/plants,/obj/item/weapon/storage/bag/plants,/turf/open/floor/plasteel/freezer{baseturf = /turf/open/floor/plating/lava/smooth},/area/ruin/powered)
"j" = (/obj/structure/table/wood,/obj/item/weapon/gun/energy/floragun,/obj/item/weapon/gun/energy/floragun,/obj/item/weapon/gun/energy/floragun,/obj/item/weapon/gun/energy/floragun,/obj/item/weapon/storage/box/disks_plantgene,/turf/open/floor/plasteel/freezer{baseturf = /turf/open/floor/plating/lava/smooth},/area/ruin/powered)
"k" = (/obj/structure/shuttle/engine/propulsion{tag = "icon-propulsion_r (WEST)"; icon_state = "propulsion_r"; dir = 8},/obj/structure/shuttle/engine/platform{dir = 4; icon_state = "platform"; pixel_x = -32; tag = "icon-platform (EAST)"},/obj/structure/shuttle/engine/platform{dir = 8},/turf/open/floor/plating/lavaland/outdoor,/area/ruin/powered)
"l" = (/turf/open/floor/plating/asteroid/basalt/lava_land_surface,/area/template_noop)
"m" = (/turf/open/floor/plasteel/freezer{baseturf = /turf/open/floor/plating/lava/smooth},/area/ruin/powered)
"n" = (/obj/structure/shuttle/engine/propulsion{tag = "icon-propulsion_l (WEST)"; icon_state = "propulsion_l"; dir = 8},/obj/structure/shuttle/engine/platform{dir = 4; icon_state = "platform"; pixel_x = -32; tag = "icon-platform (EAST)"},/obj/structure/shuttle/engine/platform{dir = 8},/turf/open/floor/plating/lavaland/outdoor,/area/ruin/powered)
"o" = (/obj/effect/mob_spawn/human/seed_vault,/turf/open/floor/plasteel/freezer{baseturf = /turf/open/floor/plating/lava/smooth},/area/ruin/powered)
"p" = (/obj/structure/sink{icon_state = "sink"; dir = 8; pixel_x = -12; pixel_y = 2},/turf/open/floor/plasteel/freezer{baseturf = /turf/open/floor/plating/lava/smooth},/area/ruin/powered)
"q" = (/obj/machinery/vending/hydronutrients,/turf/open/floor/plasteel/freezer{baseturf = /turf/open/floor/plating/lava/smooth},/area/ruin/powered)
"r" = (/obj/machinery/vending/hydroseeds,/turf/open/floor/plasteel/freezer{baseturf = /turf/open/floor/plating/lava/smooth},/area/ruin/powered)
"s" = (/obj/machinery/reagentgrinder{pixel_y = 5},/obj/structure/table/glass,/obj/item/weapon/reagent_containers/glass/beaker/bluespace,/obj/item/weapon/reagent_containers/glass/beaker/bluespace,/obj/item/weapon/reagent_containers/glass/beaker/bluespace,/obj/item/weapon/reagent_containers/glass/beaker/bluespace,/turf/open/floor/plasteel/freezer{baseturf = /turf/open/floor/plating/lava/smooth},/area/ruin/powered)
"t" = (/obj/structure/sink{dir = 4; icon_state = "sink"; pixel_x = 11; pixel_y = 0},/turf/open/floor/plasteel/freezer{baseturf = /turf/open/floor/plating/lava/smooth},/area/ruin/powered)
"u" = (/turf/closed/wall/mineral/titanium/nodiagonal{baseturf = /turf/open/floor/plating/lava/smooth},/area/ruin/powered)
"v" = (/obj/machinery/door/airlock,/turf/open/floor/plasteel/freezer{baseturf = /turf/open/floor/plating/lava/smooth},/area/ruin/powered)
"w" = (/obj/machinery/door/airlock/external,/turf/open/floor/plasteel/freezer{baseturf = /turf/open/floor/plating/lava/smooth},/area/ruin/powered)
"x" = (/obj/machinery/door/airlock/external,/obj/structure/fans/tiny,/turf/open/floor/plasteel/freezer{baseturf = /turf/open/floor/plating/lava/smooth},/area/ruin/powered)
"y" = (/obj/structure/disposalpipe/trunk,/obj/machinery/disposal/bin,/turf/open/floor/plasteel/freezer{baseturf = /turf/open/floor/plating/lava/smooth},/area/ruin/powered)
"z" = (/obj/machinery/seed_extractor,/turf/open/floor/plasteel/freezer{baseturf = /turf/open/floor/plating/lava/smooth},/area/ruin/powered)
"A" = (/obj/machinery/biogenerator,/turf/open/floor/plasteel/freezer{baseturf = /turf/open/floor/plating/lava/smooth},/area/ruin/powered)
"B" = (/obj/machinery/chem_dispenser/mutagen,/turf/open/floor/plasteel/freezer{baseturf = /turf/open/floor/plating/lava/smooth},/area/ruin/powered)
"C" = (/obj/structure/disposalpipe/segment,/turf/open/floor/plasteel/freezer{baseturf = /turf/open/floor/plating/lava/smooth},/area/ruin/powered)
"D" = (/obj/structure/closet/crate/hydroponics,/obj/item/clothing/under/rank/hydroponics,/obj/item/clothing/under/rank/hydroponics,/obj/item/clothing/under/rank/hydroponics,/obj/item/clothing/under/rank/hydroponics,/turf/open/floor/plasteel/freezer{baseturf = /turf/open/floor/plating/lava/smooth},/area/ruin/powered)
"E" = (/obj/structure/disposalpipe/segment,/obj/structure/table/wood,/obj/item/ship_in_a_bottle,/turf/open/floor/plasteel/freezer{baseturf = /turf/open/floor/plating/lava/smooth},/area/ruin/powered)
"F" = (/obj/structure/table/wood,/obj/item/device/flashlight,/obj/item/device/flashlight,/obj/item/device/flashlight,/obj/item/device/flashlight,/turf/open/floor/plasteel/freezer{baseturf = /turf/open/floor/plating/lava/smooth},/area/ruin/powered)
"G" = (/obj/machinery/chem_master/condimaster,/turf/open/floor/plasteel/freezer{baseturf = /turf/open/floor/plating/lava/smooth},/area/ruin/powered)
"H" = (/obj/structure/table/wood,/obj/item/weapon/reagent_containers/glass/bucket,/obj/item/weapon/reagent_containers/glass/bucket,/obj/item/weapon/reagent_containers/glass/bucket,/obj/item/weapon/reagent_containers/glass/bucket,/turf/open/floor/plasteel/freezer{baseturf = /turf/open/floor/plating/lava/smooth},/area/ruin/powered)
"I" = (/obj/item/weapon/storage/toolbox/syndicate,/obj/structure/table/wood,/turf/open/floor/plasteel/freezer{baseturf = /turf/open/floor/plating/lava/smooth},/area/ruin/powered)
"J" = (/obj/structure/disposalpipe/segment,/turf/closed/wall/shuttle/smooth{baseturf = /turf/open/floor/plating/lava/smooth},/area/ruin/powered)
"K" = (/obj/structure/disposalpipe/segment{dir = 1; icon_state = "pipe-c"},/turf/open/floor/plating/asteroid/basalt/lava_land_surface,/area/template_noop)
"L" = (/obj/structure/disposalpipe/trunk{dir = 8},/turf/open/floor/plating/asteroid/basalt/lava_land_surface,/area/template_noop)

(1,1,1) = {"
aaabbbbbbbbbbbbbbaaa
aabbcdefgeheijbbklll
bbbbmmmmmmmmmmbbnlll
bombpmeqcrsmmtubulll
bomvmmmmmmmmemwmxlll
bomvmmmmmmmmemwmxlll
bombpmeyzABmmtubulll
bbbbmmmCmmmmmmbbklll
aabbpDeEFeGeHIbbnlll
aaabbbbJbbbbbbbbbaaa
aaaaaaaKLlaaaaaaaaaa
"}
