"a" = (/turf/template_noop,/area/template_noop)
"b" = (/turf/open/floor/engine/cult{baseturf = /turf/open/floor/plating/asteroid/basalt/lava_land_surface; initial_gas_mix = "o2=14;n2=23;TEMP=300"},/area/template_noop)
"c" = (/obj/effect/decal/remains/human,/turf/open/floor/engine/cult{baseturf = /turf/open/floor/plating/asteroid/basalt/lava_land_surface; initial_gas_mix = "o2=14;n2=23;TEMP=300"},/area/template_noop)
"d" = (/turf/open/floor/plating/lava/smooth/lava_land_surface,/area/ruin/unpowered)
"e" = (/obj/structure/destructible/cult/pylon,/turf/open/floor/engine/cult{baseturf = /turf/open/floor/plating/asteroid/basalt/lava_land_surface; initial_gas_mix = "o2=14;n2=23;TEMP=300"},/area/template_noop)
"f" = (/turf/open/floor/plating/asteroid/basalt/lava_land_surface,/turf/closed/wall/mineral/cult{baseturf = /turf/open/floor/plating/asteroid/basalt/lava_land_surface},/area/template_noop)
"g" = (/obj/effect/decal/cleanable/blood/old,/obj/effect/step_trigger/thrower{name = "south"; tiles = 5},/obj/effect/step_trigger/sound_effect{name = "turn around"; sound = 'sound/hallucinations/turn_around1.ogg'; triggerer_only = 1},/turf/open/floor/engine/cult{baseturf = /turf/open/floor/plating/asteroid/basalt/lava_land_surface; initial_gas_mix = "o2=14;n2=23;TEMP=300"},/area/ruin/unpowered)
"h" = (/turf/open/floor/engine/cult{baseturf = /turf/open/floor/plating/asteroid/basalt/lava_land_surface; initial_gas_mix = "o2=14;n2=23;TEMP=300"},/area/ruin/unpowered)
"i" = (/obj/effect/decal/cleanable/blood/old,/turf/open/floor/engine/cult{baseturf = /turf/open/floor/plating/asteroid/basalt/lava_land_surface; initial_gas_mix = "o2=14;n2=23;TEMP=300"},/area/ruin/unpowered)
"j" = (/obj/effect/decal/remains/human,/obj/effect/decal/cleanable/blood/old,/turf/open/floor/engine/cult{baseturf = /turf/open/floor/plating/asteroid/basalt/lava_land_surface; initial_gas_mix = "o2=14;n2=23;TEMP=300"},/area/ruin/unpowered)
"k" = (/turf/open/floor/plasteel/cult{baseturf = /turf/open/floor/plating/asteroid/basalt/lava_land_surface; initial_gas_mix = "o2=14;n2=23;TEMP=300"},/turf/closed/wall/mineral/cult{baseturf = /turf/open/floor/plating/asteroid/basalt/lava_land_surface},/area/ruin/unpowered)
"l" = (/obj/effect/decal/remains/human,/obj/item/weapon/melee/cultblade,/turf/open/floor/engine/cult{baseturf = /turf/open/floor/plating/asteroid/basalt/lava_land_surface; initial_gas_mix = "o2=14;n2=23;TEMP=300"},/area/ruin/unpowered)
"m" = (/obj/effect/decal/remains/human,/obj/item/clothing/shoes/cult,/obj/item/clothing/suit/cultrobes,/turf/open/floor/engine/cult{baseturf = /turf/open/floor/plating/asteroid/basalt/lava_land_surface; initial_gas_mix = "o2=14;n2=23;TEMP=300"},/area/ruin/unpowered)
"n" = (/obj/effect/decal/remains/human,/turf/open/floor/engine/cult{baseturf = /turf/open/floor/plating/asteroid/basalt/lava_land_surface; initial_gas_mix = "o2=14;n2=23;TEMP=300"},/area/ruin/unpowered)
"o" = (/obj/effect/decal/cleanable/blood/old,/obj/effect/step_trigger/thrower{direction = 4; name = "east"; tiles = 5},/obj/effect/step_trigger/sound_effect{name = "turn around"; sound = 'sound/hallucinations/turn_around1.ogg'; triggerer_only = 1},/turf/open/floor/engine/cult{baseturf = /turf/open/floor/plating/asteroid/basalt/lava_land_surface; initial_gas_mix = "o2=14;n2=23;TEMP=300"},/area/ruin/unpowered)
"p" = (/obj/effect/rune/narsie{color = "#ff0000"; used = 1},/obj/item/device/cult_shift,/obj/effect/decal/remains/human,/obj/item/weapon/melee/cultblade/dagger,/obj/effect/step_trigger/sound_effect{happens_once = 1; name = "a grave mistake"; sound = 'sound/hallucinations/i_see_you1.ogg'; triggerer_only = 1},/obj/effect/step_trigger/message{message = "<span class='cultitalic'><b><span class='big'>You've made a grave mistake, haven't you?</span></b></span>"; name = "ohfuck"},/turf/open/floor/engine/cult{baseturf = /turf/open/floor/plating/asteroid/basalt/lava_land_surface; initial_gas_mix = "o2=14;n2=23;TEMP=300"},/area/ruin/unpowered)
"q" = (/obj/effect/decal/cleanable/blood/old,/obj/effect/step_trigger/thrower{direction = 8; name = "west"; tiles = 5},/obj/effect/step_trigger/sound_effect{name = "turn around"; sound = 'sound/hallucinations/turn_around1.ogg'; triggerer_only = 1},/turf/open/floor/engine/cult{baseturf = /turf/open/floor/plating/asteroid/basalt/lava_land_surface; initial_gas_mix = "o2=14;n2=23;TEMP=300"},/area/ruin/unpowered)
"r" = (/obj/effect/decal/remains/human,/obj/item/clothing/shoes/cult,/obj/item/clothing/suit/cultrobes,/obj/effect/decal/cleanable/blood/old,/turf/open/floor/engine/cult{baseturf = /turf/open/floor/plating/asteroid/basalt/lava_land_surface; initial_gas_mix = "o2=14;n2=23;TEMP=300"},/area/ruin/unpowered)
"s" = (/obj/effect/decal/remains/human,/obj/item/weapon/tome,/turf/open/floor/engine/cult{baseturf = /turf/open/floor/plating/asteroid/basalt/lava_land_surface; initial_gas_mix = "o2=14;n2=23;TEMP=300"},/area/ruin/unpowered)
"t" = (/obj/effect/decal/cleanable/blood/old,/obj/effect/step_trigger/thrower{direction = 1; name = "north"; tiles = 5},/obj/effect/step_trigger/sound_effect{name = "turn around"; sound = 'sound/hallucinations/turn_around1.ogg'; triggerer_only = 1},/turf/open/floor/engine/cult{baseturf = /turf/open/floor/plating/asteroid/basalt/lava_land_surface; initial_gas_mix = "o2=14;n2=23;TEMP=300"},/area/ruin/unpowered)

(1,1,1) = {"
aaaaaabbbaaaaaa
aacbbdbbbdbbcaa
acebfddgddfbeca
abbddddhddddbba
abfddhihhiddfba
adddhhjklhhddda
bbddhmhhhnhddbb
bbohhkhphkhhqbb
bbddhlhhhrhddbb
adddhhmkshhddda
abfddhhhhhddfba
abcddddhddddcba
abecfddtddfceba
aabbbdbbbdbbbaa
aaaaaabbbaaaaaa
"}
