//MAP CONVERTED BY dmm2tgm.py THIS HEADER COMMENT PREVENTS RECONVERSION, DO NOT REMOVE 
"a" = (
/turf/template_noop,
/area/template_noop)
"b" = (
/turf/closed/wall/mineral/iron,
/area/mine/shelter/ash)
"c" = (
/obj/effect/mob_spawn/human/ash_walker,
/turf/open/floor/plasteel/terror/necro/cult/outdoor,
/area/mine/shelter/ash)
"d" = (
/mob/living/simple_animal/hostile/spawner/ash_walker,
/turf/open/floor/plasteel/terror/necro/cult/outdoor,
/area/mine/shelter/ash)
"e" = (
/turf/open/floor/plasteel/terror/necro/cult/outdoor,
/area/mine/shelter/ash)
"f" = (
/obj/structure/table/wood,
/turf/open/floor/plasteel/terror/necro/cult/outdoor,
/area/mine/shelter/ash)
"g" = (
/mob/living/simple_animal/hostile/asteroid/gutlunch/guthen,
/turf/open/floor/plasteel/terror/necro/cult/outdoor,
/area/mine/shelter/ash)
"h" = (
/obj/structure/table/wood,
/turf/open/floor/plating/asteroid/basalt/lava_land_surface,
/area/mine/shelter/ash)
"i" = (
/turf/open/floor/plating/asteroid/basalt/lava_land_surface,
/area/lavaland/surface/outdoors)
"j" = (
/obj/structure/table/wood,
/obj/item/weapon/pickaxe/silver/poor,
/obj/item/weapon/pickaxe/silver/poor,
/obj/item/weapon/pickaxe/silver/poor,
/obj/item/weapon/pickaxe/silver/poor,
/obj/item/weapon/pickaxe/silver/poor,
/turf/open/floor/plasteel/terror/necro/cult/outdoor,
/area/mine/shelter/ash)
"k" = (
/obj/item/organ/tongue/lizard,
/turf/open/floor/plasteel/terror/necro/cult/outdoor,
/area/mine/shelter/ash)
"l" = (
/turf/open/floor/plating/asteroid/basalt/lava_land_surface,
/area/mine/shelter/ash)
"m" = (
/obj/structure/table/wood,
/obj/item/weapon/soap/syndie,
/turf/open/floor/plasteel/terror/necro/cult/outdoor,
/area/mine/shelter/ash)
"n" = (
/mob/living/simple_animal/hostile/asteroid/gutlunch/gubbuck,
/turf/open/floor/plasteel/terror/necro/cult/outdoor,
/area/mine/shelter/ash)
"o" = (
/turf/closed/mineral/volcanic/lava_land_surface,
/area/lavaland/surface/outdoors)
"p" = (
/obj/structure/table/wood,
/obj/item/weapon/restraints/legcuffs/bola,
/turf/open/floor/plating/asteroid/basalt/lava_land_surface,
/area/mine/shelter/ash)
"q" = (
/obj/structure/table/wood,
/obj/item/weapon/twohanded/bonespear,
/obj/item/weapon/twohanded/bonespear,
/turf/open/floor/plating/asteroid/basalt/lava_land_surface,
/area/mine/shelter/ash)
"r" = (
/obj/item/weapon/cultivator,
/turf/open/floor/plating/asteroid/basalt/lava_land_surface,
/area/mine/shelter/ash)
"s" = (
/obj/item/seeds/cherry,
/turf/open/floor/plasteel/terror/necro/cult/outdoor,
/area/mine/shelter/ash)
"t" = (
/obj/effect/mob_spawn/human/ash_walker,
/turf/open/floor/plating/asteroid/basalt/lava_land_surface,
/area/mine/shelter/ash)
"u" = (
/obj/structure/bed/roller,
/turf/open/floor/plating/asteroid/basalt/lava_land_surface,
/area/mine/shelter/ash)
"v" = (
/obj/structure/closet/crate/necropolis,
/obj/item/seeds/apple,
/obj/item/seeds/apple,
/obj/item/seeds/banana,
/obj/item/seeds/berry,
/obj/item/seeds/berry,
/obj/item/seeds/berry,
/turf/open/floor/plating/asteroid/basalt/lava_land_surface,
/area/mine/shelter/ash)
"w" = (
/obj/machinery/hydroponics/soil{
	color = "gray";
	maxnutri = 99999;
	maxwater = 99999;
	name = "necropolis' soil";
	nutrilevel = 99999;
	resistance_flags = 8;
	unsecuring_tool = null;
	waterlevel = 99999
	},
/turf/open/floor/plasteel/terror/necro/cult/outdoor,
/area/mine/shelter/ash)
"x" = (
/obj/item/weapon/bedsheet/rd,
/obj/structure/bed/dogbed,
/turf/open/floor/plating/asteroid/basalt/lava_land_surface,
/area/mine/shelter/ash)
"y" = (
/obj/structure/firepit{
	anchored = 1
	},
/turf/open/floor/plating/asteroid/basalt/lava_land_surface{
	dug = 1;
	icon_state = "basalt_dug"
	},
/area/lavaland/surface/outdoors)
"z" = (
/obj/item/weapon/reagent_containers/glass/bucket,
/turf/open/floor/plasteel/terror/necro/cult/outdoor,
/area/mine/shelter/ash)
"A" = (
/obj/structure/sink/puddle,
/turf/open/floor/plating/asteroid/basalt/lava_land_surface,
/area/mine/shelter/ash)
"B" = (
/obj/item/weapon/kitchen/knife/combat/bone,
/turf/open/floor/plating/asteroid/basalt/lava_land_surface,
/area/mine/shelter/ash)
"C" = (
/obj/item/weapon/pickaxe/speardrill,
/turf/open/floor/plating/asteroid/basalt/lava_land_surface,
/area/mine/shelter/ash)
"D" = (
/obj/item/weapon/reagent_containers/food/snacks/grown/mushroom/glowshroom,
/turf/open/floor/plasteel/terror/necro/cult/outdoor,
/area/mine/shelter/ash)
"E" = (
/obj/structure/closet/crate/necropolis,
/turf/open/floor/plating/asteroid/basalt/lava_land_surface,
/area/mine/shelter/ash)
"F" = (
/obj/structure/table/wood,
/obj/item/weapon/storage/bag/plants/portaseeder,
/turf/open/floor/plating/asteroid/basalt/lava_land_surface,
/area/mine/shelter/ash)
"G" = (
/obj/item/seeds/cocoapod,
/turf/open/floor/plating/asteroid/basalt/lava_land_surface,
/area/mine/shelter/ash)
"H" = (
/obj/item/seeds/banana,
/turf/open/floor/plating/asteroid/basalt/lava_land_surface,
/area/mine/shelter/ash)
"I" = (
/turf/closed/wall/mineral/iron,
/area/lavaland/surface/outdoors)

(1,1,1) = {"
a
a
a
a
a
a
a
a
b
b
b
b
b
a
a
a
a
a
a
"}
(2,1,1) = {"
a
a
a
a
a
I
a
b
b
p
x
B
b
b
a
a
a
a
a
"}
(3,1,1) = {"
a
a
a
I
i
i
a
b
p
l
l
l
u
b
o
i
a
a
a
"}
(4,1,1) = {"
a
a
a
a
i
i
i
b
q
t
l
C
t
b
o
i
i
i
a
"}
(5,1,1) = {"
a
a
b
b
b
i
i
b
b
u
l
l
h
b
o
o
i
i
a
"}
(6,1,1) = {"
b
b
b
j
b
b
i
i
b
b
l
b
b
I
o
i
i
i
i
"}
(7,1,1) = {"
b
c
g
e
e
b
b
i
i
i
i
i
i
i
I
i
i
i
i
"}
(8,1,1) = {"
b
c
e
k
l
l
b
i
i
i
i
i
i
i
i
i
i
i
i
"}
(9,1,1) = {"
b
d
e
l
l
l
l
i
i
i
y
i
i
i
I
i
i
i
i
"}
(10,1,1) = {"
b
e
e
l
n
l
b
i
i
i
i
i
i
i
i
i
i
i
i
"}
(11,1,1) = {"
b
f
c
e
l
b
b
i
i
i
i
i
i
i
I
i
i
i
a
"}
(12,1,1) = {"
b
b
b
m
b
b
i
i
b
b
l
b
b
b
I
o
i
a
a
"}
(13,1,1) = {"
a
a
b
b
b
i
i
i
b
t
l
l
E
b
o
o
a
a
a
"}
(14,1,1) = {"
a
a
a
a
a
i
i
o
b
v
l
l
F
b
o
o
o
a
a
"}
(15,1,1) = {"
a
a
a
a
I
i
i
b
b
b
l
l
b
b
b
o
o
a
a
"}
(16,1,1) = {"
a
a
a
a
i
i
i
b
e
e
e
l
G
e
b
o
o
a
a
"}
(17,1,1) = {"
a
a
a
a
a
I
i
b
l
w
l
e
w
e
b
o
a
a
a
"}
(18,1,1) = {"
a
a
a
a
a
a
a
b
l
e
l
l
e
l
b
o
a
a
a
"}
(19,1,1) = {"
a
a
a
a
a
a
a
b
r
w
l
e
w
H
b
a
a
a
a
"}
(20,1,1) = {"
a
a
a
a
a
a
a
b
s
l
l
D
l
e
b
a
a
a
a
"}
(21,1,1) = {"
a
a
a
a
a
a
a
b
e
w
z
e
w
r
b
a
a
a
a
"}
(22,1,1) = {"
a
a
a
a
a
a
a
b
e
l
A
e
e
e
b
a
a
a
a
"}
(23,1,1) = {"
a
a
a
a
a
a
a
b
b
b
b
b
b
b
b
a
a
a
a
"}
