"a" = (/turf/template_noop,/area/template_noop)
"b" = (/turf/closed/wall/mineral/titanium,/area/ruin/powered)
"c" = (/turf/closed/wall/mineral/titanium/nodiagonal{baseturf = /turf/open/floor/plating/lava/smooth},/area/ruin/powered)
"d" = (/obj/structure/table/wood,/obj/item/weapon/lighter,/obj/item/weapon/lighter,/obj/item/weapon/storage/fancy/rollingpapers,/obj/item/weapon/storage/fancy/rollingpapers,/obj/item/weapon/storage/fancy/rollingpapers,/obj/item/weapon/storage/fancy/rollingpapers,/turf/open/floor/plasteel/freezer{baseturf = /turf/open/floor/plating/lava/smooth},/area/ruin/powered)
"e" = (/obj/structure/table/wood,/obj/item/weapon/storage/box/disks_plantgene,/obj/machinery/light{dir = 1},/turf/open/floor/plasteel/freezer{baseturf = /turf/open/floor/plating/lava/smooth},/area/ruin/powered)
"f" = (/obj/structure/table/wood,/obj/item/weapon/storage/box/disks_plantgene,/turf/open/floor/plasteel/freezer{baseturf = /turf/open/floor/plating/lava/smooth},/area/ruin/powered)
"g" = (/obj/machinery/plantgenes/seedvault,/turf/open/floor/plasteel/freezer{baseturf = /turf/open/floor/plating/lava/smooth},/area/ruin/powered)
"h" = (/obj/structure/table/wood,/turf/open/floor/plasteel/freezer{baseturf = /turf/open/floor/plating/lava/smooth},/area/ruin/powered)
"i" = (/turf/open/floor/plasteel/freezer{baseturf = /turf/open/floor/plating/lava/smooth},/area/ruin/powered)
"j" = (/obj/machinery/light{dir = 1},/turf/open/floor/plasteel/freezer{baseturf = /turf/open/floor/plating/lava/smooth},/area/ruin/powered)
"k" = (/obj/structure/closet/crate/hydroponics,/obj/structure/beebox,/obj/item/weapon/melee/flyswatter,/obj/item/honey_frame,/obj/item/honey_frame,/obj/item/honey_frame,/obj/item/queen_bee/bought,/obj/item/clothing/head/beekeeper_head,/obj/item/clothing/suit/beekeeper_suit,/turf/open/floor/plasteel/freezer{baseturf = /turf/open/floor/plating/lava/smooth},/area/ruin/powered)
"l" = (/obj/structure/shuttle/engine/propulsion{dir = 4; icon_state = "propulsion_r"; tag = "icon-propulsion_r (WEST)"},/turf/open/floor/plating/asteroid/basalt/lava_land_surface,/area/template_noop)
"m" = (/obj/structure/closet/crate,/obj/effect/spawner/lootdrop/seed_vault,/turf/open/floor/plasteel/freezer{baseturf = /turf/open/floor/plating/lava/smooth},/area/ruin/powered)
"n" = (/obj/machinery/door/airlock,/turf/open/floor/plasteel/freezer{baseturf = /turf/open/floor/plating/lava/smooth},/area/ruin/powered)
"o" = (/obj/machinery/smartfridge,/turf/open/floor/plasteel/freezer{baseturf = /turf/open/floor/plating/lava/smooth},/area/ruin/powered)
"p" = (/obj/structure/closet/crate/hydroponics,/obj/item/weapon/cultivator,/obj/item/weapon/cultivator,/obj/item/weapon/cultivator,/obj/item/weapon/cultivator,/obj/item/weapon/shovel/spade,/obj/item/weapon/shovel/spade,/obj/item/weapon/shovel/spade,/obj/item/weapon/shovel/spade,/obj/item/weapon/hatchet,/obj/item/weapon/hatchet,/obj/item/weapon/hatchet,/obj/item/weapon/hatchet,/obj/machinery/light{dir = 1},/turf/open/floor/plasteel/freezer{baseturf = /turf/open/floor/plating/lava/smooth},/area/ruin/powered)
"q" = (/obj/machinery/hydroponics/constructable,/turf/open/floor/plasteel/freezer{baseturf = /turf/open/floor/plating/lava/smooth},/area/ruin/powered)
"r" = (/obj/item/weapon/hatchet,/obj/item/weapon/storage/bag/plants,/obj/item/weapon/reagent_containers/glass/bucket,/obj/structure/table/wood,/turf/open/floor/plasteel/freezer{baseturf = /turf/open/floor/plating/lava/smooth},/area/ruin/powered)
"s" = (/obj/structure/table/wood,/obj/item/weapon/storage/bag/plants,/obj/item/weapon/storage/bag/plants,/obj/item/weapon/storage/bag/plants,/obj/item/weapon/storage/bag/plants,/obj/machinery/light{dir = 1},/turf/open/floor/plasteel/freezer{baseturf = /turf/open/floor/plating/lava/smooth},/area/ruin/powered)
"t" = (/obj/structure/table/wood,/obj/item/weapon/gun/energy/floragun,/obj/item/weapon/gun/energy/floragun,/obj/item/weapon/gun/energy/floragun,/obj/item/weapon/gun/energy/floragun,/obj/item/weapon/storage/box/disks_plantgene,/turf/open/floor/plasteel/freezer{baseturf = /turf/open/floor/plating/lava/smooth},/area/ruin/powered)
"u" = (/obj/effect/mob_spawn/human/seed_vault,/turf/open/floor/plasteel/freezer{baseturf = /turf/open/floor/plating/lava/smooth},/area/ruin/powered)
"v" = (/obj/machinery/light/small{dir = 4},/turf/open/floor/plasteel/freezer{baseturf = /turf/open/floor/plating/lava/smooth},/area/ruin/powered)
"w" = (/obj/structure/sink{icon_state = "sink"; dir = 8; pixel_x = -12; pixel_y = 2},/turf/open/floor/plasteel/freezer{baseturf = /turf/open/floor/plating/lava/smooth},/area/ruin/powered)
"x" = (/obj/machinery/vending/hydronutrients,/turf/open/floor/plasteel/freezer{baseturf = /turf/open/floor/plating/lava/smooth},/area/ruin/powered)
"y" = (/obj/machinery/vending/hydroseeds,/turf/open/floor/plasteel/freezer{baseturf = /turf/open/floor/plating/lava/smooth},/area/ruin/powered)
"z" = (/obj/machinery/reagentgrinder{pixel_y = 5},/obj/structure/table/glass,/obj/item/weapon/reagent_containers/glass/beaker/bluespace,/obj/item/weapon/reagent_containers/glass/beaker/bluespace,/obj/item/weapon/reagent_containers/glass/beaker/bluespace,/obj/item/weapon/reagent_containers/glass/beaker/bluespace,/turf/open/floor/plasteel/freezer{baseturf = /turf/open/floor/plating/lava/smooth},/area/ruin/powered)
"A" = (/obj/structure/sink{dir = 4; icon_state = "sink"; pixel_x = 11; pixel_y = 0},/turf/open/floor/plasteel/freezer{baseturf = /turf/open/floor/plating/lava/smooth},/area/ruin/powered)
"B" = (/turf/open/floor/plating/asteroid/basalt/lava_land_surface,/area/template_noop)
"C" = (/obj/machinery/door/airlock/virology,/turf/open/floor/plasteel/freezer{baseturf = /turf/open/floor/plating/lava/smooth},/area/ruin/powered)
"D" = (/obj/machinery/light/small,/turf/open/floor/plasteel/freezer{baseturf = /turf/open/floor/plating/lava/smooth},/area/ruin/powered)
"E" = (/obj/structure/disposalpipe/trunk,/obj/machinery/disposal/bin,/turf/open/floor/plasteel/freezer{baseturf = /turf/open/floor/plating/lava/smooth},/area/ruin/powered)
"F" = (/obj/machinery/seed_extractor,/turf/open/floor/plasteel/freezer{baseturf = /turf/open/floor/plating/lava/smooth},/area/ruin/powered)
"G" = (/obj/machinery/biogenerator,/turf/open/floor/plasteel/freezer{baseturf = /turf/open/floor/plating/lava/smooth},/area/ruin/powered)
"H" = (/obj/machinery/chem_dispenser/mutagensaltpeter,/turf/open/floor/plasteel/freezer{baseturf = /turf/open/floor/plating/lava/smooth},/area/ruin/powered)
"I" = (/obj/structure/disposalpipe/segment,/turf/open/floor/plasteel/freezer{baseturf = /turf/open/floor/plating/lava/smooth},/area/ruin/powered)
"J" = (/obj/structure/closet/crate/hydroponics,/obj/item/clothing/under/rank/hydroponics,/obj/item/clothing/under/rank/hydroponics,/obj/item/clothing/under/rank/hydroponics,/obj/item/clothing/under/rank/hydroponics,/obj/machinery/light,/turf/open/floor/plasteel/freezer{baseturf = /turf/open/floor/plating/lava/smooth},/area/ruin/powered)
"K" = (/obj/structure/disposalpipe/segment,/obj/structure/table/wood,/obj/item/ship_in_a_bottle,/obj/structure/disposalpipe/segment,/turf/open/floor/plasteel/freezer{baseturf = /turf/open/floor/plating/lava/smooth},/area/ruin/powered)
"L" = (/obj/structure/table/wood,/obj/item/device/flashlight,/obj/item/device/flashlight,/obj/item/device/flashlight,/obj/item/device/flashlight,/turf/open/floor/plasteel/freezer{baseturf = /turf/open/floor/plating/lava/smooth},/area/ruin/powered)
"M" = (/obj/machinery/chem_master/condimaster,/turf/open/floor/plasteel/freezer{baseturf = /turf/open/floor/plating/lava/smooth},/area/ruin/powered)
"N" = (/obj/structure/table/wood,/obj/item/weapon/reagent_containers/glass/bucket,/obj/item/weapon/reagent_containers/glass/bucket,/obj/item/weapon/reagent_containers/glass/bucket,/obj/item/weapon/reagent_containers/glass/bucket,/obj/machinery/light,/turf/open/floor/plasteel/freezer{baseturf = /turf/open/floor/plating/lava/smooth},/area/ruin/powered)
"O" = (/obj/item/weapon/storage/toolbox/syndicate,/obj/structure/table/wood,/turf/open/floor/plasteel/freezer{baseturf = /turf/open/floor/plating/lava/smooth},/area/ruin/powered)
"P" = (/obj/structure/disposalpipe/segment,/turf/closed/wall/mineral/titanium/nodiagonal{baseturf = /turf/open/floor/plating/lava/smooth},/area/ruin/powered)
"Q" = (/obj/structure/disposalpipe/segment{dir = 1; icon_state = "pipe-c"},/turf/open/floor/plating/asteroid/basalt/lava_land_surface,/area/template_noop)
"R" = (/obj/structure/disposalpipe/trunk{dir = 8},/turf/open/floor/plating/asteroid/basalt/lava_land_surface,/area/template_noop)

(1,1,1) = {"
aaaabccccccccbaaaaaa
aaabcdefghijkcclaaaa
aaacmiiiiiiiikccaaaa
aaaccccnccccccclaaaa
aabcopqiqqrqstccaaaa
bccciiiiiiiiiiclaaaa
cuvcwiqxoyziiAcccBaa
cuiniiiiiiiiqiCiCBaa
cuiniiiiiiiiqiCDCBaa
cuvcwiqEFGHiiAcccBaa
bccciiiIiiiiiiclaaaa
aabcwJqKLqMqNOccaaaa
aaabcccPccccccclaaaa
aaaaaaaQRBaaaaaaaaaa
"}
