"a" = (/turf/template_noop,/area/template_noop)
"b" = (/turf/closed/wall/mineral/titanium,/area/ruin/powered)
"c" = (/turf/closed/wall/mineral/titanium/nodiagonal{baseturf = /turf/open/floor/plating/lava/smooth},/area/ruin/powered)
"d" = (/obj/machinery/smartfridge,/turf/open/floor/plasteel/freezer{baseturf = /turf/open/floor/plating/lava/smooth},/area/ruin/powered)
"e" = (/obj/structure/closet/crate/hydroponics,/obj/item/weapon/cultivator,/obj/item/weapon/cultivator,/obj/item/weapon/cultivator,/obj/item/weapon/cultivator,/obj/item/weapon/shovel/spade,/obj/item/weapon/shovel/spade,/obj/item/weapon/shovel/spade,/obj/item/weapon/shovel/spade,/obj/item/weapon/hatchet,/obj/item/weapon/hatchet,/obj/item/weapon/hatchet,/obj/item/weapon/hatchet,/turf/open/floor/plasteel/freezer{baseturf = /turf/open/floor/plating/lava/smooth},/area/ruin/powered)
"f" = (/obj/machinery/hydroponics/constructable,/turf/open/floor/plasteel/freezer{baseturf = /turf/open/floor/plating/lava/smooth},/area/ruin/powered)
"g" = (/obj/structure/closet/crate,/obj/effect/spawner/lootdrop/seed_vault,/turf/open/floor/plasteel/freezer{baseturf = /turf/open/floor/plating/lava/smooth},/area/ruin/powered)
"h" = (/obj/machinery/plantgenes/seedvault,/turf/open/floor/plasteel/freezer{baseturf = /turf/open/floor/plating/lava/smooth},/area/ruin/powered)
"i" = (/turf/open/floor/plasteel/freezer{baseturf = /turf/open/floor/plating/lava/smooth},/area/ruin/powered)
"j" = (/obj/structure/table/wood,/obj/item/weapon/storage/bag/plants,/obj/item/weapon/storage/bag/plants,/obj/item/weapon/storage/bag/plants,/obj/item/weapon/storage/bag/plants,/turf/open/floor/plasteel/freezer{baseturf = /turf/open/floor/plating/lava/smooth},/area/ruin/powered)
"k" = (/obj/structure/table/wood,/obj/item/weapon/gun/energy/floragun,/obj/item/weapon/gun/energy/floragun,/obj/item/weapon/gun/energy/floragun,/obj/item/weapon/gun/energy/floragun,/obj/item/weapon/storage/box/disks_plantgene,/turf/open/floor/plasteel/freezer{baseturf = /turf/open/floor/plating/lava/smooth},/area/ruin/powered)
"l" = (/obj/structure/shuttle/engine/propulsion{dir = 4; icon_state = "propulsion_l"; tag = "icon-propulsion_l (WEST)"},/obj/structure/shuttle/engine/platform{dir = 4; icon_state = "platform"; pixel_x = -32; tag = "icon-platform (EAST)"},/obj/structure/shuttle/engine/platform{dir = 8},/turf/open/floor/plating/lavaland/outdoor,/area/ruin/powered)
"m" = (/turf/open/floor/plating/asteroid/basalt/lava_land_surface,/area/template_noop)
"n" = (/obj/structure/shuttle/engine/propulsion{dir = 4; icon_state = "propulsion_r"; tag = "icon-propulsion_r (WEST)"},/obj/structure/shuttle/engine/platform{dir = 4; icon_state = "platform"; pixel_x = -32; tag = "icon-platform (EAST)"},/obj/structure/shuttle/engine/platform{dir = 8},/turf/open/floor/plating/lavaland/outdoor,/area/ruin/powered)
"o" = (/obj/effect/mob_spawn/human/seed_vault,/turf/open/floor/plasteel/freezer{baseturf = /turf/open/floor/plating/lava/smooth},/area/ruin/powered)
"p" = (/obj/structure/sink{icon_state = "sink"; dir = 8; pixel_x = -12; pixel_y = 2},/turf/open/floor/plasteel/freezer{baseturf = /turf/open/floor/plating/lava/smooth},/area/ruin/powered)
"q" = (/obj/machinery/vending/hydronutrients,/turf/open/floor/plasteel/freezer{baseturf = /turf/open/floor/plating/lava/smooth},/area/ruin/powered)
"r" = (/obj/machinery/vending/hydroseeds,/turf/open/floor/plasteel/freezer{baseturf = /turf/open/floor/plating/lava/smooth},/area/ruin/powered)
"s" = (/obj/machinery/reagentgrinder{pixel_y = 5},/obj/structure/table/glass,/obj/item/weapon/reagent_containers/glass/beaker/bluespace,/obj/item/weapon/reagent_containers/glass/beaker/bluespace,/obj/item/weapon/reagent_containers/glass/beaker/bluespace,/obj/item/weapon/reagent_containers/glass/beaker/bluespace,/turf/open/floor/plasteel/freezer{baseturf = /turf/open/floor/plating/lava/smooth},/area/ruin/powered)
"t" = (/obj/structure/sink{dir = 4; icon_state = "sink"; pixel_x = 11; pixel_y = 0},/turf/open/floor/plasteel/freezer{baseturf = /turf/open/floor/plating/lava/smooth},/area/ruin/powered)
"u" = (/obj/machinery/door/airlock/virology,/turf/open/floor/plasteel/freezer{baseturf = /turf/open/floor/plating/lava/smooth},/area/ruin/powered)
"v" = (/obj/machinery/door/airlock/virology,/obj/structure/fans/tiny,/turf/open/floor/plasteel/freezer{baseturf = /turf/open/floor/plating/lava/smooth},/area/ruin/powered)
"w" = (/obj/structure/disposalpipe/trunk,/obj/machinery/disposal/bin,/turf/open/floor/plasteel/freezer{baseturf = /turf/open/floor/plating/lava/smooth},/area/ruin/powered)
"x" = (/obj/machinery/seed_extractor,/turf/open/floor/plasteel/freezer{baseturf = /turf/open/floor/plating/lava/smooth},/area/ruin/powered)
"y" = (/obj/machinery/biogenerator,/turf/open/floor/plasteel/freezer{baseturf = /turf/open/floor/plating/lava/smooth},/area/ruin/powered)
"z" = (/obj/machinery/chem_dispenser/mutagen,/turf/open/floor/plasteel/freezer{baseturf = /turf/open/floor/plating/lava/smooth},/area/ruin/powered)
"A" = (/obj/structure/disposalpipe/segment,/turf/open/floor/plasteel/freezer{baseturf = /turf/open/floor/plating/lava/smooth},/area/ruin/powered)
"B" = (/obj/structure/closet/crate/hydroponics,/obj/item/clothing/under/rank/hydroponics,/obj/item/clothing/under/rank/hydroponics,/obj/item/clothing/under/rank/hydroponics,/obj/item/clothing/under/rank/hydroponics,/turf/open/floor/plasteel/freezer{baseturf = /turf/open/floor/plating/lava/smooth},/area/ruin/powered)
"C" = (/obj/structure/disposalpipe/segment,/obj/structure/table/wood,/obj/item/ship_in_a_bottle,/turf/open/floor/plasteel/freezer{baseturf = /turf/open/floor/plating/lava/smooth},/area/ruin/powered)
"D" = (/obj/structure/table/wood,/obj/item/device/flashlight,/obj/item/device/flashlight,/obj/item/device/flashlight,/obj/item/device/flashlight,/turf/open/floor/plasteel/freezer{baseturf = /turf/open/floor/plating/lava/smooth},/area/ruin/powered)
"E" = (/obj/machinery/chem_master/condimaster,/turf/open/floor/plasteel/freezer{baseturf = /turf/open/floor/plating/lava/smooth},/area/ruin/powered)
"F" = (/obj/structure/table/wood,/obj/item/weapon/reagent_containers/glass/bucket,/obj/item/weapon/reagent_containers/glass/bucket,/obj/item/weapon/reagent_containers/glass/bucket,/obj/item/weapon/reagent_containers/glass/bucket,/turf/open/floor/plasteel/freezer{baseturf = /turf/open/floor/plating/lava/smooth},/area/ruin/powered)
"G" = (/obj/item/weapon/storage/toolbox/syndicate,/obj/structure/table/wood,/turf/open/floor/plasteel/freezer{baseturf = /turf/open/floor/plating/lava/smooth},/area/ruin/powered)
"H" = (/obj/structure/disposalpipe/segment,/turf/closed/wall/mineral/titanium/nodiagonal{baseturf = /turf/open/floor/plating/lava/smooth},/area/ruin/powered)
"I" = (/obj/structure/disposalpipe/segment{dir = 1; icon_state = "pipe-c"},/turf/open/floor/plating/asteroid/basalt/lava_land_surface,/area/template_noop)
"J" = (/obj/structure/disposalpipe/trunk{dir = 8},/turf/open/floor/plating/asteroid/basalt/lava_land_surface,/area/template_noop)

(1,1,1) = {"
aaabccccccccccccbaaa
aabcdefghfifjkcclmmm
bccciiiiiiiiiiccnmmm
coocpifqdrsiitcccmmm
ciiuiiiiiiiifiuivmmm
ciiuiiiiiiiifiuivmmm
coocpifwxyziitcccmmm
bccciiiAiiiiiicclmmm
aabcpBfCDfEfFGccnmmm
aaabcccHccccccccbaaa
aaaaaaaIJmaaaaaaaaaa
"}
