"a" = (/turf/template_noop,/area/template_noop)
"b" = (/turf/closed/wall/mineral/titanium,/area/ruin/powered/golem_ship)
"c" = (/turf/closed/wall/mineral/titanium/nodiagonal{baseturf = /turf/open/floor/plating/lava/smooth},/area/ruin/powered/golem_ship)
"d" = (/obj/structure/closet/crate,/obj/item/weapon/pickaxe,/obj/item/weapon/pickaxe,/obj/item/weapon/pickaxe,/obj/item/weapon/storage/bag/ore,/obj/item/weapon/storage/bag/ore,/obj/item/device/mining_scanner,/obj/item/device/flashlight/lantern,/obj/item/weapon/card/id/mining,/turf/open/floor/plating/lavaland,/area/ruin/powered/golem_ship)
"e" = (/obj/structure/closet/crate,/obj/item/weapon/pickaxe,/obj/item/weapon/pickaxe,/obj/item/weapon/storage/bag/ore,/obj/item/weapon/storage/bag/ore,/obj/item/device/mining_scanner,/obj/item/device/flashlight/lantern,/obj/item/weapon/card/id/mining,/turf/open/floor/plating/lavaland,/area/ruin/powered/golem_ship)
"f" = (/obj/item/weapon/storage/toolbox/mechanical,/turf/open/floor/plating/lavaland,/area/ruin/powered/golem_ship)
"g" = (/obj/structure/reagent_dispensers/watertank,/turf/open/floor/plating/lavaland,/area/ruin/powered/golem_ship)
"h" = (/turf/open/floor/plating/lavaland,/area/ruin/powered/golem_ship)
"i" = (/obj/machinery/door/airlock/titanium,/turf/open/floor/plating/lavaland,/area/ruin/powered/golem_ship)
"j" = (/obj/structure/shuttle/engine/propulsion{dir = 4; icon_state = "propulsion_r"; tag = "icon-propulsion_r (WEST)"},/obj/structure/shuttle/engine/platform{dir = 8},/obj/structure/shuttle/engine/platform{dir = 4; pixel_x = -32},/turf/open/floor/plating/lavaland/outdoor,/area/ruin/powered/golem_ship)
"k" = (/obj/machinery/computer/arcade/battle,/turf/open/floor/mineral/titanium/purple{baseturf = /turf/open/floor/plating/lava/smooth},/area/ruin/powered/golem_ship)
"l" = (/turf/open/floor/mineral/titanium/purple{baseturf = /turf/open/floor/plating/lava/smooth},/area/ruin/powered/golem_ship)
"m" = (/obj/effect/mob_spawn/human/golem/adamantine,/turf/open/floor/mineral/titanium/purple{baseturf = /turf/open/floor/plating/lava/smooth},/area/ruin/powered/golem_ship)
"n" = (/obj/machinery/mineral/equipment_vendor/golem,/turf/open/floor/mineral/titanium/purple{baseturf = /turf/open/floor/plating/lava/smooth},/area/ruin/powered/golem_ship)
"o" = (/obj/item/weapon/resonator,/turf/open/floor/mineral/titanium/purple{baseturf = /turf/open/floor/plating/lava/smooth},/area/ruin/powered/golem_ship)
"p" = (/obj/machinery/door/airlock/titanium,/turf/open/floor/mineral/titanium/purple{baseturf = /turf/open/floor/plating/lava/smooth},/area/ruin/powered/golem_ship)
"q" = (/obj/machinery/mineral/ore_redemption{input_dir = 8},/turf/open/floor/mineral/titanium/purple{baseturf = /turf/open/floor/plating/lava/smooth},/area/ruin/powered/golem_ship)
"r" = (/obj/structure/statue/gold/rd,/obj/structure/window/reinforced{dir = 4},/turf/open/floor/mineral/titanium/purple{baseturf = /turf/open/floor/plating/lava/smooth},/area/ruin/powered/golem_ship)
"s" = (/obj/machinery/computer/shuttle,/turf/open/floor/mineral/titanium/purple{baseturf = /turf/open/floor/plating/lava/smooth},/area/ruin/powered/golem_ship)
"t" = (/obj/structure/extinguisher_cabinet{pixel_y = 30},/turf/open/floor/mineral/titanium/purple{baseturf = /turf/open/floor/plating/lava/smooth},/area/ruin/powered/golem_ship)
"u" = (/obj/machinery/door/airlock/titanium,/obj/structure/fans/tiny,/turf/open/floor/mineral/titanium/purple{baseturf = /turf/open/floor/plating/lava/smooth},/area/ruin/powered/golem_ship)
"v" = (/obj/structure/table/wood,/obj/item/weapon/bedsheet/rd{desc = "Majestic."; layer = 3; name = "Royal Cape of the Liberator"; pixel_x = 5; pixel_y = 9},/obj/item/weapon/book/manual/research_and_development{name = "Sacred Text of the Liberator"; pixel_x = -4; pixel_y = 3},/obj/structure/window/reinforced{dir = 4},/turf/open/floor/mineral/titanium/purple{baseturf = /turf/open/floor/plating/lava/smooth},/area/ruin/powered/golem_ship)
"w" = (/obj/machinery/bluespace_beacon,/turf/open/floor/mineral/titanium/purple{baseturf = /turf/open/floor/plating/lava/smooth},/area/ruin/powered/golem_ship)
"x" = (/obj/structure/extinguisher_cabinet{pixel_y = -30},/turf/open/floor/mineral/titanium/purple{baseturf = /turf/open/floor/plating/lava/smooth},/area/ruin/powered/golem_ship)
"y" = (/obj/item/weapon/resonator/upgraded,/turf/open/floor/mineral/titanium/purple{baseturf = /turf/open/floor/plating/lava/smooth},/area/ruin/powered/golem_ship)
"z" = (/obj/machinery/autolathe,/turf/open/floor/mineral/titanium/purple{baseturf = /turf/open/floor/plating/lava/smooth},/area/ruin/powered/golem_ship)
"A" = (/obj/structure/table/wood,/obj/machinery/reagentgrinder,/turf/open/floor/mineral/titanium/purple{baseturf = /turf/open/floor/plating/lava/smooth},/area/ruin/powered/golem_ship)
"B" = (/obj/machinery/computer/arcade/orion_trail,/turf/open/floor/mineral/titanium/purple{baseturf = /turf/open/floor/plating/lava/smooth},/area/ruin/powered/golem_ship)
"C" = (/obj/structure/table/wood,/obj/item/weapon/surgical_drapes{pixel_x = 15},/obj/item/weapon/storage/firstaid/fire,/obj/item/weapon/storage/firstaid/fire,/turf/open/floor/mineral/titanium/purple{baseturf = /turf/open/floor/plating/lava/smooth},/area/ruin/powered/golem_ship)
"D" = (/obj/item/weapon/storage/firstaid/fire,/obj/structure/table/wood,/obj/item/weapon/storage/firstaid/fire,/turf/open/floor/mineral/titanium/purple{baseturf = /turf/open/floor/plating/lava/smooth},/area/ruin/powered/golem_ship)
"E" = (/obj/item/weapon/storage/firstaid/brute,/obj/structure/table/wood,/obj/item/weapon/storage/firstaid/brute,/obj/item/areaeditor/blueprints{desc = "Use to build new structures in the wastes."; name = "land claim"},/turf/open/floor/mineral/titanium/purple{baseturf = /turf/open/floor/plating/lava/smooth},/area/ruin/powered/golem_ship)
"F" = (/obj/item/weapon/storage/firstaid/brute,/obj/structure/table/wood,/obj/item/weapon/storage/firstaid/brute,/obj/item/weapon/disk/design_disk/golem_shell,/turf/open/floor/mineral/titanium/purple{baseturf = /turf/open/floor/plating/lava/smooth},/area/ruin/powered/golem_ship)
"G" = (/obj/structure/reagent_dispensers/fueltank,/turf/open/floor/plating/lavaland,/area/ruin/powered/golem_ship)
"H" = (/obj/structure/ore_box,/turf/open/floor/plating/lavaland,/area/ruin/powered/golem_ship)

(1,1,1) = {"
aaaaabcccccccccccbaa
aaaaacddddddeeefgcaa
aaaaachhhhhhhhhhgccb
aabccciiccciiccccccj
aackllllmmclllllnccj
aaclllllooclllllnccj
bccppcccppclllllqccc
crsllllllllllllllptu
cvlllllllwxllllllplu
bccppcccppcllllyzccc
aaclllllooclllllAccj
aacBllllmmcllCDEFccj
aabccciiccciiccccccj
aaaaachhhhhhhhhhGccb
aaaaacHHHHHHHfhhGcaa
aaaaabcccccccccccbaa
"}
