"aa" = (/turf/open/space,/area/space)
"ab" = (/turf/closed/wall/shuttle/smooth/overspace,/area/shuttle/escape)
"ac" = (/turf/closed/wall/shuttle/smooth/nodiagonal,/area/shuttle/escape)
"ad" = (/obj/machinery/door/airlock/titanium{id_tag = "Emeregency_Shuttle_Rear_Airlock_Lock"; name = "Emergency Shuttle Airlock"; req_one_access_txt = "0"},/obj/structure/fans/tiny,/turf/open/floor/plasteel{icon_state = "delivery"; name = "floor"},/area/shuttle/escape)
"ae" = (/obj/docking_port/mobile/emergency{dheight = 0; dir = 2; dwidth = 6; height = 23; port_angle = -180; width = 14},/obj/docking_port/stationary{dheight = 0; dir = 2; dwidth = 6; height = 23; id = "emergency_home"; name = "emergency evac bay"; width = 14},/obj/machinery/door/airlock/titanium{id_tag = "Emeregency_Shuttle_Rear_Airlock_Lock"; name = "Emergency Shuttle Airlock"; req_one_access_txt = "0"},/obj/structure/fans/tiny,/turf/open/floor/plasteel{icon_state = "delivery"; name = "floor"},/area/shuttle/escape)
"af" = (/obj/structure/shuttle/engine/propulsion/burst/right{tag = "icon-burst_r (NORTH)"; icon_state = "burst_r"; dir = 1},/turf/open/floor/plating/airless/warnplate{tag = "icon-plating_warn (NORTH)"; icon_state = "plating_warn"; dir = 1},/area/shuttle/escape)
"ag" = (/obj/structure/shuttle/engine/propulsion/burst{tag = "icon-propulsion (NORTH)"; icon_state = "propulsion"; dir = 1},/turf/open/floor/plating/airless/warnplate{tag = "icon-plating_warn (NORTH)"; icon_state = "plating_warn"; dir = 1},/area/shuttle/escape)
"ah" = (/obj/structure/table,/obj/item/stack/medical/gauze,/obj/item/stack/medical/bruise_pack,/obj/item/stack/medical/ointment,/turf/open/floor/plasteel{icon_state = "bot"; dir = 1},/area/shuttle/escape)
"ai" = (/turf/open/floor/plasteel,/area/shuttle/escape)
"aj" = (/obj/structure/closet/crate/medical{name = "medical crate"},/obj/item/weapon/storage/firstaid/regular,/obj/item/weapon/storage/firstaid/o2{pixel_x = 3; pixel_y = 3},/obj/item/weapon/storage/firstaid/toxin{pixel_x = -4; pixel_y = 3},/mob/living/simple_animal/bot/medbot{name = "\improper emergency medibot"; pixel_x = -3; pixel_y = 2},/turf/open/floor/plasteel{icon_state = "bot"; dir = 1},/area/shuttle/escape)
"ak" = (/obj/structure/shuttle/engine/propulsion/burst/left{tag = "icon-burst_l (NORTH)"; icon_state = "burst_l"; dir = 1},/turf/open/floor/plating/airless/warnplate{tag = "icon-plating_warn (NORTH)"; icon_state = "plating_warn"; dir = 1},/area/shuttle/escape)
"al" = (/turf/closed/wall/mineral/plastitanium,/area/shuttle/escape)
"am" = (/obj/structure/shuttle/engine/heater{tag = "icon-heater (NORTH)"; icon_state = "heater"; dir = 1},/obj/structure/window/reinforced,/turf/open/floor/plating/airless/warnplate{tag = "icon-plating_warn (NORTH)"; icon_state = "plating_warn"; dir = 1},/area/shuttle/escape)
"an" = (/obj/structure/tank_dispenser/oxygen{layer = 2.7; pixel_x = -1; pixel_y = 2},/turf/open/floor/plasteel{icon_state = "bot"; dir = 1},/area/shuttle/escape)
"ao" = (/turf/open/floor/plasteel/neutral/corner,/area/shuttle/escape)
"ap" = (/turf/open/floor/plasteel/neutral/corner{dir = 8},/area/shuttle/escape)
"aq" = (/obj/structure/rack{dir = 1},/obj/item/weapon/tank/internals/oxygen/red,/obj/item/clothing/suit/fire/firefighter,/obj/item/clothing/mask/gas,/obj/item/clothing/head/hardhat/red,/turf/open/floor/plasteel{icon_state = "bot"; dir = 1},/area/shuttle/escape)
"ar" = (/obj/structure/window/reinforced,/obj/structure/shuttle/engine/heater{tag = "icon-heater (NORTH)"; icon_state = "heater"; dir = 1},/turf/open/floor/plating/airless/warnplate{tag = "icon-plating_warn (NORTH)"; icon_state = "plating_warn"; dir = 1},/area/shuttle/escape)
"as" = (/obj/item/clothing/suit/hazardvest{desc = "A high-visibility lifejacket complete with whistle and slot for oxygen tanks."; name = "emergency lifejacket"},/obj/item/clothing/suit/hazardvest{desc = "A high-visibility lifejacket complete with whistle and slot for oxygen tanks."; name = "emergency lifejacket"},/obj/item/clothing/suit/hazardvest{desc = "A high-visibility lifejacket complete with whistle and slot for oxygen tanks."; name = "emergency lifejacket"},/obj/item/clothing/suit/hazardvest{desc = "A high-visibility lifejacket complete with whistle and slot for oxygen tanks."; name = "emergency lifejacket"},/obj/item/clothing/suit/hazardvest{desc = "A high-visibility lifejacket complete with whistle and slot for oxygen tanks."; name = "emergency lifejacket"},/obj/item/weapon/tank/internals/emergency_oxygen/double{pixel_x = 3},/obj/item/weapon/tank/internals/emergency_oxygen/double{pixel_x = 3},/obj/item/weapon/tank/internals/emergency_oxygen/double{pixel_x = 3},/obj/item/weapon/tank/internals/emergency_oxygen/double{pixel_x = 3},/obj/item/weapon/tank/internals/emergency_oxygen/double{pixel_x = 3},/obj/item/clothing/mask/breath{pixel_x = -3; pixel_y = -3},/obj/item/clothing/mask/breath{pixel_x = -3; pixel_y = -3},/obj/item/clothing/mask/breath{pixel_x = -3; pixel_y = -3},/obj/item/clothing/mask/breath{pixel_x = -3; pixel_y = -3},/obj/item/clothing/mask/breath{pixel_x = -3; pixel_y = -3},/obj/item/clothing/head/hardhat/orange{name = "protective hat"; pixel_y = 9},/obj/item/clothing/head/hardhat/orange{name = "protective hat"; pixel_y = 9},/obj/item/clothing/head/hardhat/orange{name = "protective hat"; pixel_y = 9},/obj/item/clothing/head/hardhat/orange{name = "protective hat"; pixel_y = 9},/obj/item/clothing/head/hardhat/orange{name = "protective hat"; pixel_y = 9},/obj/structure/closet/crate{name = "lifejackets"},/turf/open/floor/plasteel{icon_state = "bot"; dir = 1},/area/shuttle/escape)
"at" = (/turf/open/floor/plasteel/neutral,/area/shuttle/escape)
"au" = (/obj/machinery/recharge_station,/obj/structure/window/reinforced,/turf/open/floor/plasteel{icon_state = "bot"; dir = 1},/area/shuttle/escape)
"av" = (/obj/machinery/vending/cigarette,/turf/open/floor/plasteel{icon_state = "bot"; dir = 1},/area/shuttle/escape)
"aw" = (/obj/machinery/vending/snack,/turf/open/floor/plasteel{icon_state = "bot"; dir = 1},/area/shuttle/escape)
"ax" = (/obj/machinery/vending/cola,/turf/open/floor/plasteel{icon_state = "bot"; dir = 1},/area/shuttle/escape)
"ay" = (/obj/structure/closet/crate/bin{pixel_y = 0},/turf/open/floor/plasteel{icon_state = "bot"; dir = 1},/area/shuttle/escape)
"az" = (/turf/open/floor/plasteel/neutral/corner{dir = 4},/area/shuttle/escape)
"aA" = (/turf/open/floor/plasteel/neutral/corner{dir = 1},/area/shuttle/escape)
"aB" = (/obj/machinery/shower{dir = 8; icon_state = "shower"; name = "emergency shower"},/turf/open/floor/plasteel,/area/shuttle/escape)
"aC" = (/obj/structure/window/shuttle,/obj/structure/grille,/turf/open/floor/plating,/area/shuttle/escape)
"aD" = (/obj/machinery/suit_storage_unit/standard_unit,/turf/open/floor/plasteel{dir = 2; icon_state = "bot"},/area/shuttle/escape)
"aE" = (/obj/structure/window/shuttle,/obj/machinery/door/poddoor/shutters{dir = 8; id = "Emergency_Shuttle_Shutters"; name = "Emergency Shuttle shutters"},/obj/structure/grille,/turf/open/floor/plating,/area/shuttle/escape)
"aF" = (/obj/machinery/door/airlock/glass_titanium{name = "Emergency Shuttle Airlock"; req_access_txt = "19"},/turf/open/floor/plasteel{icon_state = "delivery"; name = "floor"},/area/shuttle/escape)
"aG" = (/obj/structure/chair/comfy/shuttle{dir = 4},/turf/open/floor/plasteel/neutral/side{dir = 8},/area/shuttle/escape)
"aH" = (/obj/structure/sign/bluecross_2{pixel_x = 32},/obj/structure/chair/comfy/shuttle{dir = 8},/turf/open/floor/plasteel/neutral/side{dir = 4},/area/shuttle/escape)
"aI" = (/obj/structure/chair/comfy/shuttle/black,/obj/machinery/status_display{pixel_y = 31},/turf/open/floor/plasteel/shuttle/red,/area/shuttle/escape)
"aJ" = (/obj/structure/chair/comfy/shuttle/black,/obj/machinery/flasher{id = "emshuttleflash"; pixel_y = 24},/turf/open/floor/plasteel/shuttle/red,/area/shuttle/escape)
"aK" = (/obj/structure/chair/comfy/shuttle/black,/turf/open/floor/plasteel/shuttle/red,/area/shuttle/escape)
"aL" = (/obj/structure/grille,/obj/structure/window/shuttle,/turf/open/floor/plating,/area/shuttle/escape)
"aM" = (/obj/structure/chair/comfy/shuttle{dir = 4},/turf/open/floor/plasteel/neutral/corner{dir = 1},/area/shuttle/escape)
"aN" = (/obj/structure/chair/comfy/shuttle{dir = 8},/turf/open/floor/plasteel/neutral/corner{dir = 4},/area/shuttle/escape)
"aO" = (/obj/structure/curtain/medical,/obj/machinery/shower{dir = 4; icon_state = "shower"; pixel_x = 6},/turf/open/floor/plasteel{icon_state = "freezerfloor"},/area/shuttle/escape)
"aP" = (/obj/structure/table/optable,/obj/item/weapon/surgical_drapes,/obj/machinery/vending/wallmed{name = "Emergency NanoMed"; pixel_x = 0; pixel_y = 30; req_access_txt = "0"; use_power = 0},/turf/open/floor/plasteel/whiteblue,/area/shuttle/escape)
"aQ" = (/obj/structure/table,/obj/item/weapon/scalpel{pixel_y = 12},/obj/item/weapon/circular_saw,/obj/item/weapon/retractor{pixel_x = 4},/obj/item/weapon/hemostat{pixel_x = -4},/obj/item/clothing/gloves/color/latex,/obj/item/clothing/mask/surgical,/obj/structure/sign/nosmoking_2{pixel_x = 32},/obj/machinery/status_display{pixel_y = 31},/turf/open/floor/plasteel/whiteblue,/area/shuttle/escape)
"aR" = (/obj/machinery/door/airlock/titanium{id_tag = "Emeregency_Shuttle_Right_Airlock_Lock"; name = "Emergency Shuttle Airlock"; req_one_access_txt = "1;4"},/obj/structure/fans/tiny,/turf/open/floor/plasteel/shuttle/red,/area/shuttle/escape)
"aS" = (/turf/open/floor/plasteel/shuttle/red,/area/shuttle/escape)
"aT" = (/obj/machinery/door/airlock/glass_titanium{name = "Emergency Shuttle Airlock"; req_access_txt = "0"; req_one_access_txt = "1;4"},/turf/open/floor/plasteel/shuttle/red,/area/shuttle/escape)
"aU" = (/obj/machinery/door/airlock/glass_titanium{name = "Emergency Shuttle Airlock"; req_access_txt = "5"},/turf/open/floor/plasteel/whitebot/delivery,/area/shuttle/escape)
"aV" = (/turf/open/floor/plasteel/neutral{dir = 9; icon_state = "whiteblue"},/area/shuttle/escape)
"aW" = (/turf/open/floor/plasteel/neutral{dir = 1; icon_state = "whiteblue"},/area/shuttle/escape)
"aX" = (/obj/structure/chair/comfy/shuttle{dir = 8},/turf/open/floor/plasteel/neutral{dir = 5; icon_state = "whiteblue"},/area/shuttle/escape)
"aY" = (/obj/structure/table,/obj/machinery/recharger{active_power_usage = 0; idle_power_usage = 0; use_power = 0},/obj/machinery/button/flasher{id = "emshuttleflash"; name = "brig flasher button"; pixel_y = -23; req_access_txt = "0"; req_one_access_txt = "1;63;19"},/obj/item/device/radio/intercom{dir = 4; name = "Station Intercom (General)"; pixel_x = -31},/turf/open/floor/plasteel/shuttle/red,/area/shuttle/escape)
"aZ" = (/obj/structure/chair/comfy/shuttle/black{tag = "icon-shblack (NORTH)"; icon_state = "shblack"; dir = 1},/turf/open/floor/plasteel/shuttle/red,/area/shuttle/escape)
"ba" = (/obj/structure/reagent_dispensers/peppertank{pixel_x = 0; pixel_y = -29},/obj/structure/chair/comfy/shuttle/black{tag = "icon-shblack (NORTH)"; icon_state = "shblack"; dir = 1},/turf/open/floor/plasteel/shuttle/red,/area/shuttle/escape)
"bb" = (/obj/structure/chair/comfy/shuttle{dir = 4},/turf/open/floor/plasteel/neutral/corner{dir = 8},/area/shuttle/escape)
"bc" = (/obj/structure/chair/comfy/shuttle{dir = 8},/turf/open/floor/plasteel/neutral/corner,/area/shuttle/escape)
"bd" = (/obj/machinery/sleeper{icon_state = "sleeper-open"; dir = 4},/turf/open/floor/plasteel/neutral{dir = 8; icon_state = "whiteblue"},/area/shuttle/escape)
"be" = (/turf/open/floor/plasteel/neutral{icon_state = "white"},/area/shuttle/escape)
"bf" = (/obj/structure/chair/comfy/shuttle{dir = 8},/turf/open/floor/plasteel/neutral{dir = 4; icon_state = "whiteblue"},/area/shuttle/escape)
"bg" = (/obj/structure/grille,/obj/structure/window/shuttle,/obj/machinery/door/poddoor/shutters{dir = 4; id = "Emergency_Shuttle_Shutters"; name = "Emergency Shuttle shutters"},/turf/open/floor/plating,/area/shuttle/escape)
"bh" = (/obj/item/device/radio/intercom{dir = 4; name = "Station Intercom (General)"; pixel_x = -31},/obj/structure/chair/comfy/shuttle{dir = 4},/turf/open/floor/plasteel/neutral/side{dir = 8},/area/shuttle/escape)
"bi" = (/obj/structure/chair/comfy/shuttle{dir = 8},/turf/open/floor/plasteel/neutral/side{dir = 4},/area/shuttle/escape)
"bj" = (/obj/machinery/sleeper{icon_state = "sleeper-open"; dir = 4},/turf/open/floor/plasteel/neutral{dir = 10; icon_state = "whiteblue"},/area/shuttle/escape)
"bk" = (/obj/item/device/radio/intercom{broadcasting = 0; listening = 1; name = "Station Intercom (General)"; pixel_y = -30},/turf/open/floor/plasteel/neutral{icon_state = "whiteblue"},/area/shuttle/escape)
"bl" = (/obj/machinery/vending/medical,/turf/open/floor/plasteel/neutral{dir = 6; icon_state = "whiteblue"},/area/shuttle/escape)
"bm" = (/obj/structure/grille,/obj/structure/window/shuttle,/obj/machinery/door/poddoor/shutters{dir = 8; id = "Emergency_Shuttle_Shutters"; name = "Emergency Shuttle shutters"},/turf/open/floor/plating,/area/shuttle/escape)
"bn" = (/obj/structure/chair/comfy/shuttle,/turf/open/floor/wood,/area/shuttle/escape)
"bo" = (/obj/structure/chair/comfy/shuttle,/obj/item/device/radio/intercom{dir = 4; name = "Station Intercom (General)"; pixel_x = 0; pixel_y = 24},/turf/open/floor/wood,/area/shuttle/escape)
"bp" = (/obj/structure/extinguisher_cabinet{pixel_x = 27; pixel_y = 0},/obj/structure/chair/comfy/shuttle{dir = 8},/turf/open/floor/plasteel/neutral/side{dir = 4},/area/shuttle/escape)
"bq" = (/obj/machinery/door/airlock/titanium{id_tag = "Emeregency_Shuttle_Right_Airlock_Lock"; name = "Emergency Shuttle Airlock"; req_one_access_txt = "0"},/obj/structure/fans/tiny,/turf/open/floor/wood,/area/shuttle/escape)
"br" = (/turf/open/floor/carpet,/area/shuttle/escape)
"bs" = (/obj/machinery/door/airlock/glass_titanium{name = "Emergency Shuttle Airlock"},/turf/open/floor/wood,/area/shuttle/escape)
"bt" = (/obj/structure/chair/comfy/shuttle,/obj/item/device/radio/intercom{broadcasting = 0; listening = 1; name = "Station Intercom (General)"; pixel_y = 24},/turf/open/floor/plasteel{dir = 9; icon_state = "whitepurple"},/area/shuttle/escape)
"bu" = (/obj/structure/table,/obj/machinery/button/door{id = "HSS_cell_shuttle_1"; name = "HSS Cell A"; pixel_x = -6; pixel_y = 26},/obj/machinery/button/door{id = "HSS_cell_shuttle_2"; name = "HSS Cell B"; pixel_x = 6; pixel_y = 26},/obj/item/weapon/folder/white,/turf/open/floor/plasteel{dir = 1; icon_state = "whitepurple"},/area/shuttle/escape)
"bv" = (/obj/structure/closet/secure_closet/rnd_st,/turf/open/floor/plasteel{dir = 5; icon_state = "whitepurple"; tag = "icon-whitehall (WEST)"},/area/shuttle/escape)
"bw" = (/obj/structure/chair/comfy/shuttle{dir = 4},/obj/structure/extinguisher_cabinet{pixel_x = -27; pixel_y = 0},/turf/open/floor/wood,/area/shuttle/escape)
"bx" = (/turf/open/floor/wood,/area/shuttle/escape)
"by" = (/obj/structure/chair/comfy/shuttle{dir = 8},/turf/open/floor/wood,/area/shuttle/escape)
"bz" = (/obj/structure/chair/comfy/shuttle{dir = 4},/turf/open/floor/plasteel,/area/shuttle/escape)
"bA" = (/obj/machinery/door/airlock/glass_titanium{name = "Emergency Shuttle Airlock"; req_access_txt = "47"},/turf/open/floor/plasteel/whitebot/delivery,/area/shuttle/escape)
"bB" = (/turf/open/floor/plasteel{dir = 10; icon_state = "whitepurple"; tag = "icon-whitehall (WEST)"},/area/shuttle/escape)
"bC" = (/obj/machinery/computer/security/telescreen{dir = 1; name = "Storage Cell Monitor"; network = list("ST_shuttle"); pixel_x = 0; pixel_y = -30},/turf/open/floor/plasteel{dir = 2; icon_state = "whitepurple"},/area/shuttle/escape)
"bD" = (/obj/structure/sink{dir = 4; icon_state = "sink"; pixel_x = 11; pixel_y = 0},/turf/open/floor/plasteel{dir = 6; icon_state = "whitepurple"},/area/shuttle/escape)
"bE" = (/obj/machinery/door/poddoor{id = "HSS_cell_shuttle_1"; name = "HSS Cell A"},/turf/open/floor/plasteel/whitebot/delivery,/area/shuttle/escape)
"bF" = (/obj/machinery/door/poddoor{id = "HSS_cell_shuttle_2"; name = "HSS Cell B"},/turf/open/floor/plasteel/whitebot/delivery,/area/shuttle/escape)
"bG" = (/obj/structure/chair/comfy/shuttle{dir = 1},/obj/machinery/status_display{pixel_y = -31},/turf/open/floor/wood,/area/shuttle/escape)
"bH" = (/obj/machinery/vending/wallmed{name = "Emergency NanoMed"; pixel_x = 0; pixel_y = -30; req_access_txt = "0"; use_power = 0},/obj/structure/chair/comfy/shuttle{dir = 1},/turf/open/floor/wood,/area/shuttle/escape)
"bI" = (/obj/structure/chair/comfy/shuttle{dir = 1},/turf/open/floor/wood,/area/shuttle/escape)
"bJ" = (/obj/machinery/camera{c_tag = "Shuttle - Storage - Cell A"; dir = 1; network = list("ST_shuttle")},/turf/open/floor/plasteel/whitebot,/area/shuttle/escape)
"bK" = (/obj/machinery/camera{c_tag = "Shuttle - Storage - Cell B"; dir = 1; network = list("ST_shuttle")},/turf/open/floor/plasteel/whitebot,/area/shuttle/escape)
"bL" = (/obj/machinery/flasher{id = "emshuttlebridgeflash"; pixel_y = -24; use_power = 1},/obj/structure/chair/comfy/shuttle{dir = 4},/turf/open/floor/plasteel/neutral/side{dir = 10},/area/shuttle/escape)
"bM" = (/obj/structure/chair/comfy/shuttle{dir = 8},/obj/machinery/flasher{id = "emshuttlebridgeflash"; pixel_y = -24; use_power = 1},/turf/open/floor/plasteel/neutral/side{dir = 6},/area/shuttle/escape)
"bN" = (/obj/machinery/door/airlock/glass_titanium{name = "Emergency Shuttle Airlock"; req_access_txt = "19"},/obj/structure/fans/tiny,/turf/open/floor/plasteel{icon_state = "delivery"; name = "floor"},/area/shuttle/escape)
"bO" = (/obj/machinery/status_display{pixel_y = 31},/obj/machinery/computer/security,/turf/open/floor/plasteel/neutral/side{dir = 4},/area/shuttle/escape)
"bP" = (/obj/structure/chair/comfy/shuttle{dir = 8},/obj/item/device/radio/intercom{dir = 4; name = "Station Intercom (General)"; pixel_x = 0; pixel_y = 24},/turf/open/floor/plasteel/red/side{dir = 9},/area/shuttle/escape)
"bQ" = (/turf/open/floor/plasteel/red/corner{dir = 1},/area/shuttle/escape)
"bR" = (/turf/open/floor/plasteel/red/corner{dir = 4},/area/shuttle/escape)
"bS" = (/obj/machinery/button/flasher{id = "emshuttlebridgeflash"; name = "cockpit flasher button"; pixel_y = 24; req_access_txt = "0"; req_one_access_txt = "1;63;19"},/turf/open/floor/plasteel/red/side{dir = 5},/area/shuttle/escape)
"bT" = (/obj/structure/table,/obj/item/weapon/storage/firstaid/regular,/obj/item/weapon/restraints/handcuffs,/obj/machinery/status_display{pixel_y = 31},/turf/open/floor/plating{icon_state = "bot"},/area/shuttle/escape)
"bU" = (/obj/machinery/computer/crew,/turf/open/floor/plasteel/neutral/side{dir = 4},/area/shuttle/escape)
"bV" = (/obj/structure/chair/comfy/shuttle{dir = 8},/turf/open/floor/plasteel/red/side{dir = 8},/area/shuttle/escape)
"bW" = (/obj/structure/extinguisher_cabinet{pixel_x = 27; pixel_y = 0},/turf/open/floor/plasteel/red/side{dir = 4},/area/shuttle/escape)
"bX" = (/obj/machinery/computer/atmos_alert,/turf/open/floor/plasteel/neutral/side{dir = 4},/area/shuttle/escape)
"bY" = (/turf/open/floor/plasteel/red/side{dir = 10},/area/shuttle/escape)
"bZ" = (/obj/structure/chair/comfy/shuttle,/turf/open/floor/plasteel/red/side,/area/shuttle/escape)
"ca" = (/turf/open/floor/plasteel/red/side{dir = 6},/area/shuttle/escape)
"cb" = (/obj/structure/AIcore/deactivated,/turf/open/floor/circuit/green,/area/shuttle/escape)
"cc" = (/obj/structure/table,/obj/item/weapon/paper_bin,/obj/item/weapon/pen,/obj/machinery/button/door{id = "Emergency_Shuttle_Shutters"; name = "Emergency Shuttle Shutters button"; pixel_x = -24; pixel_y = 8},/obj/machinery/button/door{id = "Emeregency_Shuttle_Right_Airlock_Lock"; name = "Emeregency Shuttle Right Airlock Lock"; normaldoorcontrol = 1; pixel_x = -24; specialfunctions = 4},/obj/machinery/button/door{id = "Emeregency_Shuttle_Rear_Airlock_Lock"; name = "Emeregency Shuttle Rear Airlock Lock"; normaldoorcontrol = 1; pixel_x = -24; pixel_y = -8; specialfunctions = 4},/turf/open/floor/plasteel/neutral/side{dir = 1},/area/shuttle/escape)
"cd" = (/obj/machinery/computer/emergency_shuttle,/turf/open/floor/plasteel/neutral/side{dir = 1},/area/shuttle/escape)
"ce" = (/obj/machinery/computer/communications,/turf/open/floor/plasteel/neutral/side{dir = 1},/area/shuttle/escape)
"cf" = (/obj/structure/table,/obj/machinery/recharger{active_power_usage = 0; idle_power_usage = 0; pixel_y = 4; use_power = 0},/obj/machinery/button/door{id = "Emergency_Shuttle_Cockpit_Shutters"; name = "Cockpit Shutters button"; pixel_x = 24; pixel_y = 8},/turf/open/floor/plasteel/neutral/side{dir = 1},/area/shuttle/escape)
"cg" = (/obj/structure/grille,/obj/structure/window/shuttle,/obj/machinery/door/poddoor/shutters{id = "Emergency_Shuttle_Cockpit_Shutters"; name = "Emergency Shuttle Cockpit shutters"},/turf/open/floor/plating,/area/shuttle/escape)

(1,1,1) = {"
aaaaaaaaabacadaeacabaaaaaaaa
aaafagacacahaiaiajacacagakaa
alamamacanaiaoapaiaqacararal
acacacacasaoatatapauacacacac
acavawaxayazatataAaBaCaiaDac
aEaiaiaiaiaiazaAaiaiaFaiaDac
acacacacacaGaoapaHacacacacac
acaIaJaKaLaMatataNacaOaPaQac
aRaSaSaSaTaiazaAaiaUaVaWaXac
acaYaZbaaLbbaoapbcaCbdbebfbg
acacacacacbhatatbiaLbjbkblac
bmbnbobnaLaMazaAbpacacacacac
bqbrbrbrbsaiaoapaNacbtbubvac
acbwbxbyaLbzatataibAbBbCbDac
bqbrbrbrbsaiazaAbcacbEacbFac
bmbGbHbIaLbbaiaibiacbJacbKac
abacacacacbLapaobMacacacacab
aaaaabacacacbNbNacacacabaaaa
aaaaaaacbObPbQbRbSbTacaaaaaa
aaaaaaacbUbVaiaibWacacaaaaaa
aaaaaaacbXbYbZbZcacbacaaaaaa
aaaaaaabaccccdcecfacabaaaaaa
aaaaaaaaabcgcgcgcgabaaaaaaaa
"}
