"a" = (/turf/open/space,/area/space)
"b" = (/obj/docking_port/mobile{dheight = 0; dir = 2; dwidth = 11; height = 15; id = "whiteship"; launch_status = 0; name = "NT Recovery White-Ship"; port_angle = 180; preferred_direction = 1; roundstart_move = "whiteship_away"; timid = 1; width = 27},/obj/machinery/door/airlock/shuttle{name = "recovery shuttle external airlock"},/obj/effect/decal/cleanable/dirt{desc = "A thin layer of dust coating the floor."; name = "dust"},/turf/open/floor/mineral/titanium/blue,/area/space)
"c" = (/turf/closed/wall/r_wall,/area/space)
"d" = (/obj/structure/table{color = "#666666"},/turf/open/space,/area/space)
"e" = (/turf/closed/wall/r_wall,/area/shuttle/abandoned)
"f" = (/turf/open/space,/area/shuttle/abandoned)
"g" = (/obj/item/chair,/obj/effect/decal/cleanable/blood/old,/turf/open/space,/area/shuttle/abandoned)
"h" = (/obj/effect/decal/cleanable/dirt,/turf/open/space,/area/shuttle/abandoned)
"i" = (/obj/structure/chair{dir = 8},/turf/open/space,/area/shuttle/abandoned)
"j" = (/obj/structure/chair{dir = 8},/obj/effect/decal/cleanable/dirt,/turf/open/space,/area/shuttle/abandoned)
"k" = (/obj/structure/bed,/obj/structure/closet/wall{pixel_y = 32},/obj/item/weapon/bedsheet/random,/turf/open/space,/area/shuttle/abandoned)
"l" = (/obj/structure/bed,/obj/structure/closet/wall{dir = 8; icon_state = "w_closet"; pixel_x = 28; tag = "icon-w_closet (WEST)"},/obj/item/weapon/bedsheet/random,/turf/open/space,/area/shuttle/abandoned)
"m" = (/obj/structure/table{color = "#666666"},/obj/item/weapon/paper_bin,/obj/item/weapon/pen,/turf/open/space,/area/shuttle/abandoned)
"n" = (/obj/item/weapon/storage/secure/safe{pixel_y = 30},/obj/structure/table{color = "#666666"},/turf/open/space,/area/shuttle/abandoned)
"o" = (/obj/machinery/computer/communications,/turf/open/space,/area/shuttle/abandoned)
"p" = (/obj/structure/mirror{pixel_x = -29},/obj/structure/sink{icon_state = "sink"; dir = 8; pixel_x = -12; pixel_y = 2},/turf/open/space,/area/shuttle/abandoned)
"q" = (/obj/structure/chair/comfy/black{dir = 4},/turf/open/space,/area/shuttle/abandoned)
"r" = (/obj/machinery/computer/shuttle,/turf/open/space,/area/shuttle/abandoned)
"s" = (/obj/structure/table{color = "#666666"},/turf/open/space,/area/shuttle/abandoned)
"t" = (/obj/structure/bed,/obj/structure/closet/wall{dir = 1; pixel_y = -32},/obj/item/weapon/bedsheet/random,/turf/open/space,/area/shuttle/abandoned)
"u" = (/obj/structure/closet/cabinet,/turf/open/space,/area/shuttle/abandoned)
"v" = (/obj/structure/bed,/obj/item/weapon/bedsheet/black,/turf/open/space,/area/shuttle/abandoned)
"w" = (/obj/structure/table{color = "#666666"},/obj/item/weapon/folder/red,/turf/open/space,/area/shuttle/abandoned)
"x" = (/obj/machinery/computer/security,/turf/open/space,/area/shuttle/abandoned)
"y" = (/turf/open/floor/mineral/titanium/blue,/area/shuttle/abandoned)

(1,1,1) = {"
aaaaaaaaaaaaaaaaaaaaaaaaaaabaa
aaaaaaaaaaaaaaaaaaaaaaaaaaaaaa
aaaaaaaaaaaaaaaaaaaaaaaaaaaaaa
aaaaaaaaaaaaaaaaaaaaaaaaaaaaaa
aaaaaaaaaaaaaaaaaaaaaaaaaaaaaa
aaaaaaaaaaaaaaaaaaaaaaaaaaaaaa
aaaaccaaaaaaccaaaaaaaaaaaaaaaa
aaaaacaaaaaaacaaaaaaaaaaaaaaaa
aaccccccccccccccaacaaaaaaaaaaa
aacaaaaaaaacaaacaaccccaaaaaaaa
aacaaaaaaaacaaacaacaaccaaaaaaa
aacaaaaadaacaaaaaaaaaacaaaaaaa
aacaaaaaaaacccccaaccaccaaaaaaa
aaeefffffffffeffffeffgeaaaaaaa
afffffffffffffffffehfieaaaaaaa
affffffffffffffffffffjeaaaaaaa
afeeefeeefeeeeeeffehfieaaaaaaa
afekkfleffmnoeffffefhiefffaaaa
efeffflepffqreffffesseefffaaaa
efettfleuvfwxeffffeeeeffffaaaa
yfeeeeeeeeeeeeeeeeefffffffaaaa
effffefffffffeffffffffffffaaaa
efffeeffffffeeffffffffffffaaaa
afffffffffffffffffffffffffaaaa
affffffffffffffffffffffaaaaaaa
affffffffffffffffffffffaaaaaaa
affffffffffffffffffffffaaaaaaa
aafffffffffffffffffffffaaaaaaa
"}
