"aa" = (/turf/open/space,/area/space)
"ab" = (/turf/closed/wall/mineral/titanium,/area/shuttle/abandoned)
"ac" = (/turf/closed/wall/mineral/titanium/nodiagonal,/area/shuttle/abandoned)
"ad" = (/obj/structure/grille,/obj/structure/window/shuttle,/turf/open/floor/plating,/area/shuttle/abandoned)
"ae" = (/obj/docking_port/mobile{dheight = 0; dir = 2; dwidth = 11; height = 15; id = "whiteship"; launch_status = 0; name = "NT Recovery White-Ship"; port_angle = -90; roundstart_move = "whiteship_away"; width = 27},/obj/machinery/door/airlock/shuttle{name = "recovery shuttle external airlock"},/turf/open/floor/plasteel/shuttle,/area/shuttle/abandoned)
"af" = (/obj/machinery/door/airlock/titanium{name = "recovery shuttle external airlock"},/turf/open/floor/mineral/titanium/blue,/area/shuttle/abandoned)
"ag" = (/obj/structure/shuttle/engine/propulsion{dir = 8; icon_state = "propulsion"},/obj/structure/shuttle/engine/platform{dir = 4},/obj/structure/shuttle/engine/platform{dir = 8; pixel_x = 32},/turf/open/floor/plating/airless,/area/shuttle/abandoned)
"ah" = (/obj/structure/toilet{pixel_y = 9},/turf/open/floor/mineral/titanium,/area/shuttle/abandoned)
"ai" = (/obj/structure/mirror{pixel_x = 28; pixel_y = 0},/obj/structure/sink{dir = 4; icon_state = "sink"; pixel_x = 11; pixel_y = 0},/turf/open/floor/mineral/titanium,/area/shuttle/abandoned)
"aj" = (/obj/structure/closet/wardrobe/mixed,/turf/open/floor/mineral/titanium,/area/shuttle/abandoned)
"ak" = (/obj/structure/table,/obj/item/weapon/storage/pill_bottle/dice{pixel_y = 3},/turf/open/floor/mineral/titanium,/area/shuttle/abandoned)
"al" = (/obj/structure/table,/obj/item/stack/sheet/metal{amount = 50},/obj/item/weapon/stock_parts/cell/high{charge = 100; maxcharge = 15000; pixel_y = 2},/turf/open/floor/mineral/titanium,/area/shuttle/abandoned)
"am" = (/obj/machinery/suit_storage_unit/terror/breath,/turf/open/floor/mineral/titanium,/area/shuttle/abandoned)
"an" = (/obj/machinery/suit_storage_unit/standard_unit,/turf/open/floor/mineral/titanium,/area/shuttle/abandoned)
"ao" = (/obj/structure/tank_dispenser/oxygen{layer = 2.7; pixel_x = -1; pixel_y = 2},/turf/open/floor/mineral/titanium,/area/shuttle/abandoned)
"ap" = (/turf/closed/wall/shuttle{icon_state = "swall1"},/area/shuttle/abandoned)
"aq" = (/obj/structure/sign/vacuum{pixel_x = -32},/turf/open/floor/mineral/titanium/blue,/area/shuttle/abandoned)
"ar" = (/turf/open/floor/mineral/titanium/blue,/area/shuttle/abandoned)
"as" = (/obj/structure/closet/crate/medical{name = "medical crate"},/obj/item/weapon/storage/firstaid/o2{pixel_x = 3; pixel_y = 3},/obj/item/roller{pixel_y = 4},/obj/item/device/healthanalyzer,/turf/open/floor/plasteel/bot,/area/shuttle/abandoned)
"at" = (/obj/structure/closet/crate{name = "spare equipment crate"},/obj/item/weapon/grenade/chem_grenade/metalfoam,/obj/item/weapon/relic,/obj/item/device/t_scanner,/obj/effect/spawner/lootdrop/maintenance{lootcount = 3; name = "3maintenance loot spawner"},/turf/open/floor/plasteel/bot,/area/shuttle/abandoned)
"au" = (/obj/item/weapon/storage/box/lights/mixed,/obj/item/weapon/cigbutt,/obj/structure/closet/crate{icon_state = "crateopen"; name = "spare equipment crate"; opened = 1},/obj/item/weapon/tank/internals/oxygen/red,/obj/item/weapon/tank/internals/air,/obj/effect/spawner/lootdrop/maintenance{lootcount = 2; name = "2maintenance loot spawner"},/obj/item/clothing/mask/breath,/obj/item/clothing/mask/breath,/turf/open/floor/plasteel/bot,/area/shuttle/abandoned)
"av" = (/obj/structure/closet/crate{name = "emergency supplies crate"},/obj/item/weapon/storage/toolbox/emergency,/obj/item/weapon/storage/toolbox/emergency,/obj/item/device/flashlight/flare{pixel_x = 3; pixel_y = 3},/obj/item/device/flashlight/flare{pixel_x = -6; pixel_y = -2},/obj/item/weapon/crowbar,/obj/item/weapon/wrench,/obj/effect/spawner/lootdrop/maintenance,/obj/item/weapon/extinguisher,/obj/item/weapon/extinguisher,/turf/open/floor/plasteel/bot,/area/shuttle/abandoned)
"aw" = (/obj/machinery/door/airlock/titanium{name = "bathroom"},/turf/open/floor/mineral/titanium/blue,/area/shuttle/abandoned)
"ax" = (/obj/structure/bed,/obj/item/weapon/bedsheet/nanotrasen,/turf/open/floor/mineral/titanium,/area/shuttle/abandoned)
"ay" = (/obj/structure/table,/obj/item/weapon/storage/belt/utility,/obj/item/weapon/storage/belt/utility,/obj/item/device/radio/off,/obj/item/device/radio/off,/obj/item/device/radio/off,/obj/item/device/radio/off,/turf/open/floor/mineral/titanium,/area/shuttle/abandoned)
"az" = (/obj/machinery/door/airlock/titanium{name = "E.V.A. equipment"},/turf/open/floor/mineral/titanium/blue,/area/shuttle/abandoned)
"aA" = (/obj/machinery/door/airlock/titanium{name = "cargo bay"},/turf/open/floor/plasteel/delivery{dir = 1},/area/shuttle/abandoned)
"aB" = (/turf/open/floor/plasteel/delivery{dir = 1},/area/shuttle/abandoned)
"aC" = (/obj/machinery/shower{icon_state = "shower"; dir = 4},/obj/machinery/door/window/westright{dir = 4},/obj/item/weapon/soap/nanotrasen,/turf/open/floor/mineral/titanium,/area/shuttle/abandoned)
"aD" = (/obj/structure/mirror{pixel_x = 28; pixel_y = 0},/turf/open/floor/mineral/titanium/blue,/area/shuttle/abandoned)
"aE" = (/obj/structure/table,/obj/item/stack/sheet/glass{amount = 50; pixel_x = -2; pixel_y = 2},/obj/item/stack/rods{amount = 50},/obj/item/weapon/wrench,/turf/open/floor/mineral/titanium,/area/shuttle/abandoned)
"aF" = (/obj/structure/rack{dir = 8; layer = 2.9; pixel_y = 2},/obj/item/weapon/storage/toolbox/electrical{pixel_x = 1; pixel_y = 6},/obj/item/weapon/storage/toolbox/mechanical{pixel_x = -2; pixel_y = -1},/obj/item/clothing/head/welding{pixel_x = -3; pixel_y = 5},/obj/item/clothing/glasses/welding,/turf/open/floor/mineral/titanium,/area/shuttle/abandoned)
"aG" = (/obj/machinery/portable_atmospherics/canister/oxygen,/turf/open/floor/mineral/titanium,/area/shuttle/abandoned)
"aH" = (/obj/machinery/recharge_station,/turf/open/floor/plating{icon_state = "bot"},/area/shuttle/abandoned)
"aI" = (/obj/structure/closet/emcloset,/turf/open/floor/plasteel/bot,/area/shuttle/abandoned)
"aJ" = (/obj/structure/closet/firecloset/full,/turf/open/floor/plasteel/bot,/area/shuttle/abandoned)
"aK" = (/obj/structure/shuttle/engine/propulsion{dir = 8; icon_state = "propulsion_l"},/obj/structure/shuttle/engine/platform{dir = 4},/obj/structure/shuttle/engine/platform{dir = 8; pixel_x = 32},/turf/open/floor/plating/airless,/area/shuttle/abandoned)
"aL" = (/obj/machinery/door/airlock/titanium{name = "dormitory"},/turf/open/floor/mineral/titanium/blue,/area/shuttle/abandoned)
"aM" = (/obj/machinery/vending/boozeomat{icon_deny = "smartfridge"; icon_state = "smartfridge"; req_access_txt = "0"; use_power = 0},/turf/closed/wall/mineral/titanium/nodiagonal,/area/shuttle/abandoned)
"aN" = (/obj/machinery/door/airlock/titanium{name = "recovery shuttle interior airlock"},/turf/open/floor/mineral/titanium/blue,/area/shuttle/abandoned)
"aO" = (/obj/machinery/vending/cigarette{use_power = 0},/turf/open/floor/mineral/titanium,/area/shuttle/abandoned)
"aP" = (/obj/structure/frame/computer{anchored = 1},/turf/open/floor/mineral/titanium,/area/shuttle/abandoned)
"aQ" = (/obj/structure/table,/obj/item/device/camera,/turf/open/floor/mineral/titanium,/area/shuttle/abandoned)
"aR" = (/obj/structure/table,/obj/machinery/recharger,/turf/open/floor/mineral/titanium,/area/shuttle/abandoned)
"aS" = (/obj/structure/table,/obj/item/weapon/paper_bin{pixel_x = -1; pixel_y = 6},/turf/open/floor/mineral/titanium,/area/shuttle/abandoned)
"aT" = (/obj/structure/reagent_dispensers/fueltank,/obj/structure/sign/vacuum{pixel_x = -32},/turf/open/floor/mineral/titanium/blue,/area/shuttle/abandoned)
"aU" = (/obj/machinery/vending/coffee{pixel_x = -2; use_power = 0},/turf/open/floor/mineral/titanium,/area/shuttle/abandoned)
"aV" = (/turf/open/floor/mineral/titanium,/area/shuttle/abandoned)
"aW" = (/obj/structure/chair,/turf/open/floor/mineral/titanium,/area/shuttle/abandoned)
"aX" = (/obj/structure/hyper_sleep{tag = "icon-body_scanner_0 (NORTH)"; icon_state = "body_scanner_0"; dir = 1},/turf/open/floor/mineral/titanium,/area/shuttle/abandoned)
"aY" = (/obj/structure/chair/comfy/shuttle{dir = 1},/turf/open/floor/mineral/titanium,/area/shuttle/abandoned)
"aZ" = (/obj/structure/table,/obj/item/weapon/folder/blue,/turf/open/floor/mineral/titanium,/area/shuttle/abandoned)
"ba" = (/obj/structure/chair{dir = 4},/turf/open/floor/mineral/titanium,/area/shuttle/abandoned)
"bb" = (/obj/structure/table,/obj/item/weapon/reagent_containers/food/drinks/shaker,/turf/open/floor/mineral/titanium,/area/shuttle/abandoned)
"bc" = (/obj/structure/table,/obj/item/weapon/reagent_containers/food/condiment/peppermill{pixel_x = 3; pixel_y = 4},/obj/item/weapon/reagent_containers/food/condiment/saltshaker{pixel_x = -3; pixel_y = 4},/turf/open/floor/mineral/titanium,/area/shuttle/abandoned)
"bd" = (/obj/structure/table,/obj/item/weapon/storage/fancy/donut_box,/turf/open/floor/mineral/titanium,/area/shuttle/abandoned)
"be" = (/obj/structure/chair{dir = 8},/turf/open/floor/mineral/titanium,/area/shuttle/abandoned)
"bf" = (/obj/machinery/door/airlock/titanium{name = "living quarters"},/turf/open/floor/mineral/titanium/blue,/area/shuttle/abandoned)
"bg" = (/obj/item/roller{pixel_x = -3; pixel_y = 7},/obj/item/roller{pixel_x = 3; pixel_y = 4},/obj/item/weapon/reagent_containers/spray/cleaner,/obj/structure/table,/turf/open/floor/mineral/titanium,/area/shuttle/abandoned)
"bh" = (/obj/item/clothing/suit/bio_suit,/obj/item/clothing/suit/bio_suit,/obj/item/clothing/gloves/color/latex,/obj/item/clothing/gloves/color/latex,/obj/item/clothing/head/bio_hood,/obj/item/clothing/head/bio_hood,/obj/item/clothing/mask/breath,/obj/item/clothing/mask/breath,/obj/structure/table,/turf/open/floor/mineral/titanium,/area/shuttle/abandoned)
"bi" = (/obj/item/clothing/gloves/color/black,/obj/item/clothing/gloves/color/black,/obj/item/clothing/suit/armor/vest,/obj/item/clothing/suit/armor/vest,/obj/structure/table,/obj/item/clothing/head/helmet/swat/nanotrasen,/obj/item/clothing/head/helmet/swat/nanotrasen,/turf/open/floor/mineral/titanium,/area/shuttle/abandoned)
"bj" = (/obj/item/weapon/storage/toolbox/emergency{pixel_x = -3; pixel_y = 3},/obj/item/weapon/storage/toolbox/emergency,/obj/item/weapon/storage/toolbox/emergency{pixel_x = 3; pixel_y = -3},/obj/structure/table,/turf/open/floor/mineral/titanium,/area/shuttle/abandoned)
"bk" = (/obj/machinery/door/airlock/titanium{name = "bridge"},/turf/open/floor/mineral/titanium/blue,/area/shuttle/abandoned)
"bl" = (/obj/structure/chair/comfy/shuttle{dir = 4},/turf/open/floor/mineral/titanium,/area/shuttle/abandoned)
"bm" = (/obj/machinery/computer/shuttle/white_ship,/turf/open/floor/mineral/titanium,/area/shuttle/abandoned)
"bn" = (/obj/structure/reagent_dispensers/watertank,/turf/open/floor/mineral/titanium/blue,/area/shuttle/abandoned)
"bo" = (/obj/machinery/vending/cola{pixel_x = -1; use_power = 0},/turf/open/floor/mineral/titanium,/area/shuttle/abandoned)
"bp" = (/obj/structure/chair{dir = 1},/turf/open/floor/mineral/titanium,/area/shuttle/abandoned)
"bq" = (/obj/structure/hyper_sleep,/turf/open/floor/mineral/titanium,/area/shuttle/abandoned)
"br" = (/obj/structure/chair/comfy/shuttle,/turf/open/floor/mineral/titanium,/area/shuttle/abandoned)
"bs" = (/obj/item/weapon/phone{pixel_x = -3; pixel_y = 3},/obj/item/weapon/cigbutt/cigarbutt{pixel_x = 5; pixel_y = -1},/obj/structure/table,/turf/open/floor/mineral/titanium,/area/shuttle/abandoned)
"bt" = (/obj/machinery/vending/snack{pixel_x = -1; use_power = 0},/turf/open/floor/mineral/titanium,/area/shuttle/abandoned)
"bu" = (/obj/structure/sign/science{pixel_y = -32},/turf/open/floor/mineral/titanium/blue,/area/shuttle/abandoned)
"bv" = (/obj/structure/table,/obj/item/device/megaphone,/turf/open/floor/mineral/titanium,/area/shuttle/abandoned)
"bw" = (/obj/structure/table,/obj/item/device/mass_spectrometer,/turf/open/floor/mineral/titanium,/area/shuttle/abandoned)
"bx" = (/obj/structure/table,/obj/item/device/radio/off{pixel_y = 6},/turf/open/floor/mineral/titanium,/area/shuttle/abandoned)
"by" = (/obj/structure/sign/botany,/turf/closed/wall/mineral/titanium/nodiagonal,/area/shuttle/abandoned)
"bz" = (/obj/machinery/door/airlock/titanium{name = "hydroponics"},/turf/open/floor/mineral/titanium/blue,/area/shuttle/abandoned)
"bA" = (/obj/machinery/door/airlock/titanium{name = "kitchen"},/turf/open/floor/mineral/titanium/blue,/area/shuttle/abandoned)
"bB" = (/obj/machinery/door/airlock/titanium{name = "laboratory"},/turf/open/floor/mineral/titanium/blue,/area/shuttle/abandoned)
"bC" = (/obj/structure/sign/bluecross_2,/turf/closed/wall/mineral/titanium/nodiagonal,/area/shuttle/abandoned)
"bD" = (/obj/machinery/door/airlock/titanium{icon_state = "closed"; name = "medbay"; welded = 0},/turf/open/floor/mineral/titanium/blue,/area/shuttle/abandoned)
"bE" = (/obj/item/weapon/storage/bag/plants/portaseeder,/obj/structure/table,/obj/item/weapon/reagent_containers/spray/plantbgone{pixel_x = 13; pixel_y = 5},/obj/item/weapon/reagent_containers/glass/bottle/nutrient/ez,/obj/item/weapon/reagent_containers/glass/bottle/nutrient/ez,/obj/item/weapon/reagent_containers/glass/bottle/nutrient/ez,/obj/item/weapon/reagent_containers/glass/bottle/nutrient/rh{pixel_x = -2; pixel_y = 3},/turf/open/floor/mineral/titanium,/area/shuttle/abandoned)
"bF" = (/obj/machinery/biogenerator{idle_power_usage = 0; use_power = 0},/turf/open/floor/mineral/titanium,/area/shuttle/abandoned)
"bG" = (/obj/machinery/vending/hydroseeds{pixel_x = 2; use_power = 0},/turf/open/floor/mineral/titanium,/area/shuttle/abandoned)
"bH" = (/obj/machinery/processor,/turf/open/floor/mineral/titanium,/area/shuttle/abandoned)
"bI" = (/obj/structure/kitchenspike,/turf/open/floor/mineral/titanium,/area/shuttle/abandoned)
"bJ" = (/obj/structure/table,/obj/machinery/microwave{pixel_x = -3; pixel_y = 6},/obj/item/weapon/storage/box/donkpockets,/turf/open/floor/mineral/titanium,/area/shuttle/abandoned)
"bK" = (/obj/structure/frame/machine,/turf/open/floor/mineral/titanium,/area/shuttle/abandoned)
"bL" = (/obj/structure/frame/machine,/obj/item/weapon/circuitboard/machine/autolathe,/turf/open/floor/mineral/titanium,/area/shuttle/abandoned)
"bM" = (/obj/machinery/sleeper{dir = 4; use_power = 0},/turf/open/floor/mineral/titanium,/area/shuttle/abandoned)
"bN" = (/obj/structure/closet/crate/freezer,/obj/item/weapon/reagent_containers/blood/empty{pixel_x = -3; pixel_y = -3},/obj/item/weapon/reagent_containers/blood/OMinus,/obj/item/weapon/reagent_containers/blood/random,/turf/open/floor/mineral/titanium,/area/shuttle/abandoned)
"bO" = (/obj/structure/table/optable,/obj/item/weapon/surgical_drapes,/obj/item/weapon/storage/firstaid/regular,/turf/open/floor/mineral/titanium,/area/shuttle/abandoned)
"bP" = (/obj/structure/table,/obj/item/weapon/wrench,/obj/item/weapon/crowbar,/obj/item/clothing/suit/apron,/obj/item/weapon/shovel/spade,/obj/item/weapon/cultivator,/obj/item/weapon/wirecutters,/obj/item/device/plant_analyzer,/obj/item/weapon/reagent_containers/glass/bucket,/turf/open/floor/mineral/titanium,/area/shuttle/abandoned)
"bQ" = (/obj/structure/sink{dir = 4; icon_state = "sink"; pixel_x = 11; pixel_y = 0},/turf/open/floor/mineral/titanium/blue,/area/shuttle/abandoned)
"bR" = (/obj/machinery/smartfridge{use_power = 0},/turf/closed/wall/mineral/titanium/nodiagonal,/area/shuttle/abandoned)
"bS" = (/obj/structure/sink{icon_state = "sink"; dir = 8; pixel_x = -12; pixel_y = 2},/turf/open/floor/mineral/titanium/blue,/area/shuttle/abandoned)
"bT" = (/obj/structure/table,/obj/item/weapon/kitchen/rollingpin,/obj/item/weapon/kitchen/knife,/turf/open/floor/mineral/titanium,/area/shuttle/abandoned)
"bU" = (/obj/structure/frame/machine,/obj/item/weapon/circuitboard/machine/chem_dispenser,/turf/open/floor/mineral/titanium,/area/shuttle/abandoned)
"bV" = (/obj/structure/chair/office/light,/turf/open/floor/mineral/titanium/blue,/area/shuttle/abandoned)
"bW" = (/obj/machinery/vending/wallmed{name = "Emergency NanoMed"; pixel_x = -28; pixel_y = 0; req_access_txt = "0"; use_power = 0},/obj/machinery/iv_drip{density = 0; pixel_x = -8},/turf/open/floor/mineral/titanium/blue,/area/shuttle/abandoned)
"bX" = (/obj/machinery/hydroponics/constructable,/turf/open/floor/mineral/titanium,/area/shuttle/abandoned)
"bY" = (/obj/machinery/hydroponics/constructable,/obj/item/seeds/glowshroom,/turf/open/floor/mineral/titanium,/area/shuttle/abandoned)
"bZ" = (/obj/structure/table,/obj/machinery/reagentgrinder{pixel_y = 6},/turf/open/floor/mineral/titanium,/area/shuttle/abandoned)
"ca" = (/obj/structure/table,/obj/item/weapon/storage/box/monkeycubes{pixel_y = 4},/obj/item/weapon/storage/fancy/egg_box{pixel_y = 5},/turf/open/floor/mineral/titanium,/area/shuttle/abandoned)
"cb" = (/obj/structure/table,/obj/item/weapon/reagent_containers/glass/beaker{pixel_x = 5},/obj/item/weapon/reagent_containers/food/condiment/enzyme{layer = 5},/obj/item/weapon/reagent_containers/dropper,/turf/open/floor/mineral/titanium,/area/shuttle/abandoned)
"cc" = (/obj/structure/table,/obj/item/weapon/reagent_containers/food/condiment/flour,/obj/item/weapon/reagent_containers/food/condiment/flour,/obj/item/weapon/reagent_containers/food/condiment/flour,/obj/item/weapon/reagent_containers/food/condiment/flour,/obj/item/weapon/reagent_containers/food/condiment/milk,/obj/item/weapon/reagent_containers/food/condiment/milk,/obj/item/weapon/reagent_containers/food/condiment/milk,/obj/item/weapon/reagent_containers/food/condiment/soymilk,/obj/item/weapon/reagent_containers/food/condiment/soymilk,/obj/item/weapon/reagent_containers/food/condiment/sugar,/obj/item/weapon/reagent_containers/food/condiment/sugar,/obj/item/weapon/reagent_containers/food/condiment/sugar,/turf/open/floor/mineral/titanium,/area/shuttle/abandoned)
"cd" = (/obj/structure/table,/obj/item/weapon/reagent_containers/glass/beaker{pixel_x = 5; pixel_y = 2},/obj/item/weapon/reagent_containers/glass/beaker,/obj/item/weapon/reagent_containers/dropper,/obj/item/weapon/reagent_containers/syringe,/turf/open/floor/mineral/titanium,/area/shuttle/abandoned)
"ce" = (/obj/structure/table,/obj/item/weapon/folder/white,/turf/open/floor/mineral/titanium,/area/shuttle/abandoned)
"cf" = (/obj/structure/table,/obj/item/weapon/hand_labeler,/turf/open/floor/mineral/titanium,/area/shuttle/abandoned)
"cg" = (/obj/structure/table,/obj/item/weapon/defibrillator,/turf/open/floor/mineral/titanium,/area/shuttle/abandoned)
"ch" = (/obj/structure/table,/obj/item/weapon/reagent_containers/glass/bottle/epinephrine{pixel_x = 6; pixel_y = 0},/obj/item/weapon/reagent_containers/glass/bottle/charcoal{pixel_x = -3},/obj/item/weapon/reagent_containers/syringe,/turf/open/floor/mineral/titanium,/area/shuttle/abandoned)
"ci" = (/obj/structure/table,/obj/item/clothing/gloves/color/latex,/obj/item/clothing/mask/surgical,/obj/item/clothing/suit/apron/surgical,/turf/open/floor/mineral/titanium,/area/shuttle/abandoned)
"cj" = (/obj/structure/table,/obj/item/weapon/storage/backpack/dufflebag/med/surgery,/turf/open/floor/mineral/titanium,/area/shuttle/abandoned)

(1,1,1) = {"
aaaaabacacadacadacacacadadacacaeafacacadadacabaaaaaaaa
aaagacacahaiacajakacalamanaoapaqaracasatauavacaaaaaaaa
aaagacacacawacaraxacayarararazararaAaBaBaBaBadaaaaaaaa
aaagacacaCaDacaraxacaEaFaraGacararacaHaBaIaJacaaaaaaaa
aaaKacacacawacaLaMacacacazacacaNaNacacaAacacacadadabaa
abadacaOarararararararacararararararararacaPaQaRaSadaa
acaTacaUaraVaWaWaWaVaracaraXaXararaXaXaracaYararaZadaa
afaraNararbabbbcbdbearbfarbgbhaVaVbibjarbkararblbmadaa
acbnacboaraVbpbpbpaVaracarbqbqararbqbqaracbrararbsadaa
abadacbtarararararararacararbuarararararacaPbvbwbxadaa
aaagacacacbybzacacbAacacacacacbBacacbCbDacacacadadabaa
aaagacacbEbFarbGacarbHbIbJacbKarbLacbMarbNbOacaaaaaaaa
aaagacacbPararbQbRbSararbTacbUbVaPacbWararbQadaaaaaaaa
aaaKacacbXbXbYbXacbZcacbccaccdcecfaccgchcicjacaaaaaaaa
aaaaabacacadadacacacadadacacacadacacacadadacabaaaaaaaa
"}
