"a" = (/turf/closed/wall/mineral/abductor/terror,/area/shuttle/abandoned)
"b" = (/obj/machinery/door/airlock/abductor/base,/obj/docking_port/mobile{dheight = 0; dir = 2; dwidth = 10; height = 15; id = "whiteship"; launch_status = 0; name = "Alien Trooper's Ship"; port_angle = 180; preferred_direction = 1; roundstart_move = "whiteship_away"; timid = 1; width = 25},/obj/structure/fans/tiny{color = "purple"},/turf/open/floor/plating/abductor,/area/shuttle/abandoned)
"c" = (/obj/machinery/door/airlock/abductor/base,/obj/structure/fans/tiny{color = "purple"},/turf/open/floor/plating/abductor,/area/shuttle/abandoned)
"d" = (/turf/open/space,/area/space)
"e" = (/obj/structure/shuttle/engine/propulsion{color = "purple"; dir = 8; icon_state = "propulsion"},/obj/structure/shuttle/engine/platform{dir = 4},/obj/structure/shuttle/engine/platform{dir = 8; pixel_x = 32},/turf/open/floor/plating/abductor2,/area/shuttle/abandoned)
"f" = (/obj/structure/chair,/turf/open/floor/plating/abductor,/area/shuttle/abandoned)
"g" = (/turf/open/floor/plating/abductor,/area/shuttle/abandoned)
"h" = (/obj/machinery/vending/eatimat,/turf/open/floor/plating/abductor,/area/shuttle/abandoned)
"i" = (/obj/structure/alien_structure,/turf/open/floor/plating/abductor,/area/shuttle/abandoned)
"j" = (/obj/structure/closet/abductor,/obj/effect/spawner/lootdrop/alien,/obj/effect/spawner/lootdrop/alien,/obj/effect/spawner/lootdrop/alien,/obj/effect/spawner/lootdrop/alien,/turf/open/floor/plating/abductor,/area/shuttle/abandoned)
"k" = (/obj/structure/sign/directions/alien,/turf/closed/wall/mineral/abductor/terror,/area/shuttle/abandoned)
"l" = (/obj/structure/closet/body_bag/bluespace,/turf/open/floor/plating/abductor,/area/shuttle/abandoned)
"m" = (/obj/structure/table/abductor,/turf/open/floor/plating/abductor,/area/shuttle/abandoned)
"n" = (/obj/structure/chair{tag = "icon-chair (WEST)"; icon_state = "chair"; dir = 8},/turf/open/floor/plating/abductor,/area/shuttle/abandoned)
"o" = (/obj/structure/chair{tag = "icon-chair (NORTH)"; icon_state = "chair"; dir = 1},/turf/open/floor/plating/abductor,/area/shuttle/abandoned)
"p" = (/obj/effect/mob_spawn/human/abductor/agent,/turf/open/floor/plating/abductor2,/area/shuttle/abandoned)
"q" = (/obj/structure/chair/comfy/shuttle/black/noNT,/turf/open/floor/plating/abductor,/area/shuttle/abandoned)
"r" = (/obj/machinery/computer/camera_advanced/abductor{team = 1},/turf/open/floor/plating/abductor2,/area/shuttle/abandoned)
"s" = (/obj/structure/table/abductor,/obj/machinery/recharger,/turf/open/floor/plating/abductor,/area/shuttle/abandoned)
"t" = (/obj/machinery/recharger/wallcharger{pixel_x = -26},/turf/open/floor/plating/abductor,/area/shuttle/abandoned)
"u" = (/obj/structure/chair/comfy/shuttle/black/noNT{tag = "icon-shblackS (NORTH)"; icon_state = "shblackS"; dir = 1},/turf/open/floor/plating/abductor,/area/shuttle/abandoned)
"v" = (/obj/machinery/power/rtg/abductor,/turf/open/floor/plating/abductor,/area/shuttle/abandoned)
"w" = (/obj/structure/table/abductor,/obj/effect/spawner/lootdrop/alien,/turf/open/floor/plating/abductor,/area/shuttle/abandoned)
"x" = (/obj/structure/table/abductor,/obj/item/stack/sheet/cloth/ten,/turf/open/floor/plating/abductor,/area/shuttle/abandoned)
"y" = (/obj/structure/chair/comfy/shuttle/black/noNT{tag = "icon-shblackS (EAST)"; icon_state = "shblackS"; dir = 4},/turf/open/floor/plating/abductor,/area/shuttle/abandoned)
"z" = (/obj/machinery/computer/shuttle/white_ship{name = "Alien Ship Console"},/turf/open/floor/plating/abductor,/area/shuttle/abandoned)
"A" = (/obj/effect/mob_spawn/human/abductor/scientist,/turf/open/floor/plating/abductor,/area/shuttle/abandoned)
"B" = (/obj/structure/table/optable/abductor,/turf/open/floor/plating/abductor2,/area/shuttle/abandoned)
"C" = (/obj/structure/table/abductor,/obj/item/weapon/scalpel/alien,/obj/item/weapon/circular_saw/alien,/turf/open/floor/plating/abductor,/area/shuttle/abandoned)
"D" = (/obj/structure/table/abductor,/obj/item/bodybag/bluespace,/obj/item/bodybag/bluespace,/obj/item/bodybag/bluespace,/obj/item/bodybag/bluespace,/obj/item/bodybag/bluespace,/obj/item/bodybag/bluespace,/turf/open/floor/plating/abductor,/area/shuttle/abandoned)
"E" = (/obj/machinery/abductor/pad{team = 1},/turf/open/floor/plating/abductor,/area/shuttle/abandoned)
"F" = (/obj/structure/table/abductor,/obj/item/stack/sheet/mineral/abductor{amount = 50},/turf/open/floor/plating/abductor,/area/shuttle/abandoned)
"G" = (/obj/machinery/sleeper/syndie/alien{tag = "icon-sleeper_s (EAST)"; icon_state = "sleeper_s"; dir = 4},/turf/open/floor/plating/abductor2,/area/shuttle/abandoned)
"H" = (/obj/structure/table/abductor,/obj/item/weapon/surgical_drapes,/turf/open/floor/plating/abductor,/area/shuttle/abandoned)
"I" = (/obj/structure/table/abductor,/obj/item/weapon/surgicaldrill/alien,/obj/item/weapon/retractor/alien,/turf/open/floor/plating/abductor,/area/shuttle/abandoned)
"J" = (/obj/structure/table/abductor,/obj/item/stack/sheet/metal/fifty,/obj/item/stack/sheet/metal/fifty,/obj/item/stack/sheet/metal/fifty,/obj/item/stack/sheet/metal/fifty,/turf/open/floor/plating/abductor,/area/shuttle/abandoned)
"K" = (/obj/structure/table/abductor,/obj/item/weapon/cautery/alien,/obj/item/weapon/hemostat/alien,/turf/open/floor/plating/abductor,/area/shuttle/abandoned)
"L" = (/obj/structure/closet/abductor,/obj/effect/spawner/lootdrop/alien,/obj/effect/spawner/lootdrop/alien,/obj/effect/spawner/lootdrop/alien,/obj/effect/spawner/lootdrop/alien,/obj/effect/spawner/lootdrop/alien,/obj/effect/spawner/lootdrop/alien,/obj/effect/spawner/lootdrop/alien,/obj/effect/spawner/lootdrop/alien,/turf/open/floor/plating/abductor2,/area/shuttle/abandoned)
"M" = (/obj/structure/table/abductor,/obj/item/stack/sheet/glass/fifty,/obj/item/stack/sheet/glass/fifty,/obj/item/stack/sheet/glass/fifty,/turf/open/floor/plating/abductor,/area/shuttle/abandoned)

(1,1,1) = {"
aaaaaaaaaaaaaabcaaaaaaddd
eaafggghaijjjkggklllladdd
eaamngghaggggcggcggggaadd
eaaoggghaggggkggkllllaadd
eaaakcaaaaacaaccaaaaaaaaa
aapgggggggagqqggqqiarmmma
aapggggsggatgggggggkuggma
aapggvgsggcggwwwxggcggyza
aapggggsggatgggggggkAggma
aapgggggggaguugguugammmma
eaaakcaaaaacaaccaacaaaaaa
eaaBggCaDDEgaFggaGgHIaadd
eaaHggIaggggaJggaGggBkadd
eaaBggKaLLLLaMggaGgKCaddd
aaaaaaaaaaaaaaaaaaaaaaddd
"}
