"aa" = (/turf/open/space,/area/space)
"ab" = (/turf/closed/wall/mineral/titanium{color = "#512705"},/area/shuttle/abandoned)
"ac" = (/obj/structure/grille,/obj/structure/window/reinforced/fulltile{color = "#C25B0A"},/turf/open/floor/plating,/area/shuttle/abandoned)
"ad" = (/obj/item/weapon/banner/red,/turf/closed/wall/mineral/titanium{color = "#512705"},/area/shuttle/abandoned)
"ae" = (/obj/docking_port/mobile{dheight = 0; dir = 2; dwidth = 11; height = 15; id = "whiteship"; launch_status = 0; name = "Knight's Ship"; port_angle = 180; preferred_direction = 1; roundstart_move = "whiteship_away"; timid = 1; width = 27},/obj/machinery/door/airlock/wood,/obj/structure/fans/tiny,/turf/open/floor/wood,/area/shuttle/abandoned)
"af" = (/obj/machinery/door/airlock/wood,/obj/structure/fans/tiny,/turf/open/floor/wood,/area/shuttle/abandoned)
"ag" = (/obj/structure/shuttle/engine/propulsion{dir = 8},/turf/open/floor/plating/airless,/area/shuttle/abandoned)
"ah" = (/obj/structure/shuttle/engine/heater{icon_state = "heater"; dir = 8},/turf/open/floor/plating/lava,/area/shuttle/abandoned)
"ai" = (/turf/open/floor/plating/lava,/area/shuttle/abandoned)
"aj" = (/obj/structure/toilet{pixel_y = 9},/turf/open/floor/wood,/area/shuttle/abandoned)
"ak" = (/obj/structure/mirror{pixel_x = 28; pixel_y = 0},/obj/structure/sink{dir = 4; icon_state = "sink"; pixel_x = 11; pixel_y = 0},/turf/open/floor/wood,/area/shuttle/abandoned)
"al" = (/obj/structure/closet/wardrobe/mixed,/turf/open/floor/wood,/area/shuttle/abandoned)
"am" = (/obj/structure/table/wood,/obj/item/weapon/storage/pill_bottle/dice{pixel_y = 3},/obj/machinery/light{dir = 1},/turf/open/floor/wood,/area/shuttle/abandoned)
"an" = (/obj/machinery/suit_storage_unit/standard_unit{helmet_type = null; name = "knight's armory storage unit"; suit_type = /obj/item/clothing/suit/space/hardsuit/ert/paranormal/inquisitor},/turf/open/floor/wood,/area/shuttle/abandoned)
"ao" = (/obj/structure/tank_dispenser/oxygen{layer = 2.7; pixel_x = -1; pixel_y = 2},/turf/open/floor/wood,/area/shuttle/abandoned)
"ap" = (/obj/structure/sign/vacuum{pixel_x = -32},/turf/open/floor/wood,/area/shuttle/abandoned)
"aq" = (/turf/open/floor/wood,/area/shuttle/abandoned)
"ar" = (/obj/structure/closet,/obj/item/clothing/suit/armor/riot/knight/templar,/obj/item/clothing/head/helmet/knight/templar,/obj/item/weapon/nullrod/claymore,/obj/item/weapon/shield/riot/roman,/obj/item/clothing/shoes/roman,/obj/item/clothing/gloves/color/black,/obj/item/weapon/storage/backpack/bannerpack/red,/obj/item/weapon/storage/belt/military/army,/obj/item/device/radio/headset/binary{icon_state = "syndie_headset"; name = "knight's headset"},/turf/open/floor/wood,/area/shuttle/abandoned)
"as" = (/obj/machinery/telecomms/relay/preset/mining,/turf/open/floor/wood,/area/shuttle/abandoned)
"at" = (/obj/machinery/door/airlock/wood,/turf/open/floor/wood,/area/shuttle/abandoned)
"au" = (/turf/open/floor/carpet,/area/shuttle/abandoned)
"av" = (/obj/structure/bed,/obj/item/weapon/bedsheet/wiz,/turf/open/floor/carpet,/area/shuttle/abandoned)
"aw" = (/obj/machinery/shower{icon_state = "shower"; dir = 4},/obj/machinery/door/window/westright{dir = 4},/obj/item/weapon/soap/deluxe,/turf/open/floor/wood,/area/shuttle/abandoned)
"ax" = (/obj/structure/mirror{pixel_x = 28; pixel_y = 0},/turf/open/floor/wood,/area/shuttle/abandoned)
"ay" = (/obj/machinery/light,/obj/structure/rack,/obj/item/weapon/gun/energy/e_gun/nuclear,/obj/item/weapon/gun/energy/e_gun/nuclear,/obj/item/weapon/gun/energy/e_gun/nuclear,/obj/item/weapon/gun/energy/e_gun/nuclear,/obj/item/weapon/storage/box/firingpins,/turf/open/floor/wood,/area/shuttle/abandoned)
"az" = (/obj/machinery/suit_storage_unit/standard_unit{color = "purple"; helmet_type = null; name = "mage's armory storage unit"; suit_type = /obj/item/clothing/suit/space/hardsuit/wizard},/turf/open/floor/wood,/area/shuttle/abandoned)
"aA" = (/obj/machinery/portable_atmospherics/canister/oxygen,/turf/open/floor/wood,/area/shuttle/abandoned)
"aB" = (/obj/structure/punching_bag,/turf/open/floor/carpet,/area/shuttle/abandoned)
"aC" = (/obj/structure/closet/wardrobe/chaplain_black,/obj/item/weapon/storage/backpack/cultpack,/obj/item/device/radio/headset/binary{icon_state = "syndie_headset"; name = "knight's headset"},/turf/open/floor/carpet,/area/shuttle/abandoned)
"aD" = (/obj/structure/closet/wardrobe/mixed,/turf/open/floor/carpet,/area/shuttle/abandoned)
"aE" = (/obj/structure/destructible/cult/forge{desc = "A engine used in powering the wizards ship"; name = "magma engine"},/turf/open/floor/wood,/area/shuttle/abandoned)
"aF" = (/obj/machinery/vending/boozeomat{icon_deny = "smartfridge"; icon_state = "smartfridge"; req_access_txt = "0"; use_power = 0},/turf/closed/wall/shuttle{icon_state = "swall12"; dir = 2},/area/shuttle/abandoned)
"aG" = (/obj/machinery/vending/cigarette{use_power = 0},/turf/open/floor/wood,/area/shuttle/abandoned)
"aH" = (/obj/machinery/light{dir = 1},/obj/item/weapon/twohanded/required/kirbyplants{tag = "icon-plant-12"; icon_state = "plant-12"; layer = 4.1; pixel_y = 3},/turf/open/floor/wood,/area/shuttle/abandoned)
"aI" = (/obj/item/weapon/twohanded/required/kirbyplants{tag = "icon-plant-21"; icon_state = "plant-21"},/turf/open/floor/wood,/area/shuttle/abandoned)
"aJ" = (/obj/machinery/light{dir = 1},/obj/item/weapon/twohanded/required/kirbyplants{icon_state = "plant-08"; layer = 4.1; tag = "icon-plant-08"},/turf/open/floor/wood,/area/shuttle/abandoned)
"aK" = (/obj/structure/table/wood,/obj/machinery/light{dir = 1},/obj/item/weapon/statuebust,/turf/open/floor/wood,/area/shuttle/abandoned)
"aL" = (/obj/machinery/computer/camera_advanced,/turf/open/floor/wood,/area/shuttle/abandoned)
"aM" = (/obj/structure/table/wood,/obj/item/weapon/storage/book/bible,/turf/open/floor/wood,/area/shuttle/abandoned)
"aN" = (/obj/structure/table/wood,/obj/item/weapon/paper_bin{pixel_x = -1; pixel_y = 6},/turf/open/floor/wood,/area/shuttle/abandoned)
"aO" = (/obj/structure/reagent_dispensers/fueltank,/obj/structure/sign/vacuum{pixel_x = -32},/turf/open/floor/wood,/area/shuttle/abandoned)
"aP" = (/obj/machinery/vending/coffee{pixel_x = -2; use_power = 0},/turf/open/floor/wood,/area/shuttle/abandoned)
"aQ" = (/obj/structure/chair/wood/normal,/turf/open/floor/carpet,/area/shuttle/abandoned)
"aR" = (/obj/structure/chair/comfy/brown{dir = 1},/turf/open/floor/carpet,/area/shuttle/abandoned)
"aS" = (/obj/structure/table/wood,/obj/item/weapon/folder/blue,/turf/open/floor/wood,/area/shuttle/abandoned)
"aT" = (/obj/structure/chair/wood/wings{tag = "icon-wooden_chair_wings (EAST)"; icon_state = "wooden_chair_wings"; dir = 4},/turf/open/floor/carpet,/area/shuttle/abandoned)
"aU" = (/obj/structure/table/wood,/turf/open/floor/carpet,/area/shuttle/abandoned)
"aV" = (/obj/structure/table/wood,/obj/item/weapon/storage/bag/tray,/obj/item/weapon/reagent_containers/food/snacks/burger/spell,/turf/open/floor/carpet,/area/shuttle/abandoned)
"aW" = (/obj/structure/chair/wood/wings{tag = "icon-wooden_chair_wings (WEST)"; icon_state = "wooden_chair_wings"; dir = 8},/turf/open/floor/carpet,/area/shuttle/abandoned)
"aX" = (/obj/structure/table/wood,/obj/item/weapon/statuebust,/turf/open/floor/carpet,/area/shuttle/abandoned)
"aY" = (/obj/structure/table/wood,/obj/item/weapon/storage/book/bible,/turf/open/floor/carpet,/area/shuttle/abandoned)
"aZ" = (/obj/structure/table/wood,/obj/item/weapon/storage/fancy/candle_box,/obj/item/weapon/storage/fancy/candle_box,/turf/open/floor/carpet,/area/shuttle/abandoned)
"ba" = (/obj/structure/chair/comfy/brown{color = "#596479"; dir = 4},/turf/open/floor/carpet,/area/shuttle/abandoned)
"bb" = (/obj/machinery/computer/shuttle/white_ship{desc = "Used to control the Knight's Ship."; name = "Knights Ship Console"; possible_destinations = "whiteship_away;whiteship_home;whiteship_z4;whiteship_z4_2;whiteship_lavaland;whiteship_z5;whiteship_test"},/turf/open/floor/wood,/area/shuttle/abandoned)
"bc" = (/obj/structure/reagent_dispensers/watertank,/turf/open/floor/wood,/area/shuttle/abandoned)
"bd" = (/obj/machinery/vending/cola{pixel_x = -1; use_power = 0},/turf/open/floor/wood,/area/shuttle/abandoned)
"be" = (/obj/structure/chair/wood/normal{icon_state = "wooden_chair"; dir = 1},/turf/open/floor/carpet,/area/shuttle/abandoned)
"bf" = (/obj/structure/chair/comfy/brown,/turf/open/floor/carpet,/area/shuttle/abandoned)
"bg" = (/obj/structure/table/wood,/turf/open/floor/wood,/area/shuttle/abandoned)
"bh" = (/obj/machinery/vending/snack{pixel_x = -1; use_power = 0},/turf/open/floor/wood,/area/shuttle/abandoned)
"bi" = (/obj/machinery/light,/turf/open/floor/wood,/area/shuttle/abandoned)
"bj" = (/obj/item/weapon/twohanded/required/kirbyplants{icon_state = "applebush"; layer = 4.1; tag = "icon-applebush"},/turf/open/floor/wood,/area/shuttle/abandoned)
"bk" = (/obj/machinery/light,/obj/item/weapon/twohanded/required/kirbyplants{icon_state = "plant-10"; layer = 4.1; tag = "icon-plant-10"},/turf/open/floor/wood,/area/shuttle/abandoned)
"bl" = (/obj/item/weapon/twohanded/required/kirbyplants{icon_state = "plant-10"; layer = 4.1; tag = "icon-plant-10"},/turf/open/floor/wood,/area/shuttle/abandoned)
"bm" = (/obj/structure/table/wood,/obj/machinery/light,/obj/item/weapon/twohanded/required/kirbyplants{icon_state = "plant-13"; layer = 4.1; tag = "icon-plant-13"},/turf/open/floor/wood,/area/shuttle/abandoned)
"bn" = (/obj/machinery/computer/communications,/turf/open/floor/wood,/area/shuttle/abandoned)
"bo" = (/obj/structure/table/wood,/obj/item/device/radio/off{pixel_y = 6},/turf/open/floor/wood,/area/shuttle/abandoned)
"bp" = (/obj/structure/sign/botany,/turf/closed/wall/mineral/titanium{color = "#512705"},/area/shuttle/abandoned)
"bq" = (/obj/structure/sign/bluecross_2,/turf/closed/wall/mineral/titanium{color = "#512705"},/area/shuttle/abandoned)
"br" = (/obj/item/weapon/storage/bag/plants/portaseeder,/obj/structure/table/wood,/obj/item/weapon/reagent_containers/spray/plantbgone{pixel_x = 13; pixel_y = 5},/obj/item/weapon/reagent_containers/glass/bottle/nutrient/ez,/obj/item/weapon/reagent_containers/glass/bottle/nutrient/ez,/obj/item/weapon/reagent_containers/glass/bottle/nutrient/ez,/obj/item/weapon/reagent_containers/glass/bottle/nutrient/rh{pixel_x = -2; pixel_y = 3},/obj/machinery/light{dir = 1},/turf/open/floor/wood,/area/shuttle/abandoned)
"bs" = (/obj/machinery/biogenerator{idle_power_usage = 0; use_power = 0},/turf/open/floor/carpet,/area/shuttle/abandoned)
"bt" = (/obj/machinery/vending/hydroseeds{pixel_x = 2; use_power = 0},/turf/open/floor/wood,/area/shuttle/abandoned)
"bu" = (/obj/machinery/processor,/obj/machinery/light{dir = 1},/turf/open/floor/carpet,/area/shuttle/abandoned)
"bv" = (/obj/structure/kitchenspike,/turf/open/floor/carpet,/area/shuttle/abandoned)
"bw" = (/obj/structure/table/wood,/obj/machinery/microwave{pixel_x = -3; pixel_y = 6},/obj/item/weapon/storage/box/donkpockets,/turf/open/floor/carpet,/area/shuttle/abandoned)
"bx" = (/obj/machinery/vending/magivend/terror,/turf/open/floor/carpet,/area/shuttle/abandoned)
"by" = (/obj/machinery/light{dir = 1},/obj/structure/bookcase/random/reference,/turf/open/floor/carpet,/area/shuttle/abandoned)
"bz" = (/obj/machinery/sleeper{dir = 4; use_power = 0},/turf/open/floor/carpet,/area/shuttle/abandoned)
"bA" = (/obj/structure/closet/crate/freezer,/obj/item/weapon/reagent_containers/blood/empty{pixel_x = -3; pixel_y = -3},/obj/item/weapon/reagent_containers/blood/OMinus,/obj/item/weapon/reagent_containers/blood/random,/obj/machinery/light{dir = 1},/turf/open/floor/carpet,/area/shuttle/abandoned)
"bB" = (/obj/structure/table/optable,/obj/item/weapon/surgical_drapes,/obj/item/weapon/storage/firstaid/regular,/turf/open/floor/carpet,/area/shuttle/abandoned)
"bC" = (/obj/structure/table/wood,/obj/item/weapon/wrench,/obj/item/weapon/crowbar,/obj/item/clothing/suit/apron,/obj/item/weapon/shovel/spade,/obj/item/weapon/cultivator,/obj/item/weapon/wirecutters,/obj/item/device/plant_analyzer,/obj/item/weapon/reagent_containers/glass/bucket,/turf/open/floor/wood,/area/shuttle/abandoned)
"bD" = (/obj/structure/sink{dir = 4; icon_state = "sink"; pixel_x = 11; pixel_y = 0},/turf/open/floor/carpet,/area/shuttle/abandoned)
"bE" = (/obj/machinery/smartfridge{use_power = 0},/turf/closed/wall/mineral/titanium{color = "#512705"},/area/shuttle/abandoned)
"bF" = (/obj/structure/sink{icon_state = "sink"; dir = 8; pixel_x = -12; pixel_y = 2},/turf/open/floor/carpet,/area/shuttle/abandoned)
"bG" = (/obj/structure/table/wood,/obj/item/weapon/kitchen/rollingpin,/obj/item/weapon/kitchen/knife,/turf/open/floor/wood,/area/shuttle/abandoned)
"bH" = (/obj/machinery/vending/wallmed{name = "Emergency NanoMed"; pixel_x = -28; pixel_y = 0; req_access_txt = "0"; use_power = 0},/obj/machinery/iv_drip{density = 0; pixel_x = -8},/turf/open/floor/carpet,/area/shuttle/abandoned)
"bI" = (/obj/machinery/hydroponics/constructable,/turf/open/floor/wood,/area/shuttle/abandoned)
"bJ" = (/obj/structure/table/wood,/obj/machinery/reagentgrinder{pixel_y = 6},/turf/open/floor/wood,/area/shuttle/abandoned)
"bK" = (/obj/structure/table/wood,/obj/item/weapon/storage/box/monkeycubes{pixel_y = 4},/obj/item/weapon/storage/fancy/egg_box{pixel_y = 5},/turf/open/floor/wood,/area/shuttle/abandoned)
"bL" = (/obj/structure/table/wood,/obj/item/weapon/reagent_containers/glass/beaker{pixel_x = 5},/obj/item/weapon/reagent_containers/food/condiment/enzyme{layer = 5},/obj/item/weapon/reagent_containers/dropper,/turf/open/floor/wood,/area/shuttle/abandoned)
"bM" = (/obj/structure/table/wood,/obj/item/weapon/reagent_containers/food/condiment/flour,/obj/item/weapon/reagent_containers/food/condiment/flour,/obj/item/weapon/reagent_containers/food/condiment/flour,/obj/item/weapon/reagent_containers/food/condiment/flour,/obj/item/weapon/reagent_containers/food/condiment/milk,/obj/item/weapon/reagent_containers/food/condiment/milk,/obj/item/weapon/reagent_containers/food/condiment/milk,/obj/item/weapon/reagent_containers/food/condiment/soymilk,/obj/item/weapon/reagent_containers/food/condiment/soymilk,/obj/item/weapon/reagent_containers/food/condiment/sugar,/obj/item/weapon/reagent_containers/food/condiment/sugar,/obj/item/weapon/reagent_containers/food/condiment/sugar,/turf/open/floor/wood,/area/shuttle/abandoned)
"bN" = (/obj/structure/table/wood/fancy,/obj/item/weapon/spellbook{desc = "A mega powerful tome for real cool Knights!"; name = "mega spell book"; uses = 80},/obj/item/weapon/storage/backpack/bannerpack/red,/obj/item/weapon/storage/belt/wands/full,/obj/item/clothing/gloves/color/black,/obj/item/clothing/shoes/roman,/obj/item/device/radio/headset/binary{icon_state = "syndie_headset"; name = "knight's headset"},/turf/open/floor/carpet,/area/shuttle/abandoned)
"bO" = (/obj/structure/destructible/cult/tome,/turf/open/floor/carpet,/area/shuttle/abandoned)
"bP" = (/obj/structure/dresser,/turf/open/floor/carpet,/area/shuttle/abandoned)
"bQ" = (/obj/structure/table/wood,/obj/item/weapon/defibrillator,/turf/open/floor/wood,/area/shuttle/abandoned)
"bR" = (/obj/structure/table/wood,/obj/item/weapon/reagent_containers/glass/bottle/epinephrine{pixel_x = 6; pixel_y = 0},/obj/item/weapon/reagent_containers/glass/bottle/charcoal{pixel_x = -3},/obj/item/weapon/reagent_containers/syringe,/turf/open/floor/wood,/area/shuttle/abandoned)
"bS" = (/obj/structure/table/wood,/obj/item/clothing/gloves/color/latex,/obj/item/clothing/mask/surgical,/obj/item/clothing/suit/apron/surgical,/turf/open/floor/wood,/area/shuttle/abandoned)
"bT" = (/obj/structure/table/wood,/obj/item/weapon/storage/backpack/dufflebag/med{contents = newlist(/obj/item/weapon/scalpel,/obj/item/weapon/hemostat,/obj/item/weapon/retractor,/obj/item/weapon/cautery,/obj/item/weapon/circular_saw,/obj/item/weapon/surgicaldrill,/obj/item/weapon/razor); desc = "A large dufflebag for holding extra medical supplies - this one seems to be designed for holding surgical tools."; name = "surgical dufflebag"; pixel_y = 4},/turf/open/floor/wood,/area/shuttle/abandoned)

(1,1,1) = {"
aaababababacabacabababacacabadaeafadabacacababaaaaaaaa
agahaiacajakabalamabanananaoabapaqabarararasabaaaaaaaa
agahaiababatabauavadauauauauafaqaqafauauauauacaaaaaaaa
agahaiacawaxabauavabayazauaAabaqaqabaBauaCaDabaaaaaaaa
agahaEadabatabataFabababatabadafafadabatababadacacabaa
adacabaGaHaqaIaqaqaqaJabaqaqaqaqaqaqaqaqabaKaLaMaNacaa
abaOabaPaqauaQaQaQauaqabaqaQaQaqaqaQaQaqabauaRauaSacaa
afaqafaqaqaTaUaUaVaWaqataqaXaUauauaYaZaqatauaubabbacaa
abbcabbdaqaubebebeauaqabaqbebeaqaqbebeaqabaubfaubgacaa
adacabbhbibjaqaqaqaqbkabblaqaqaqaqaqaqaqabbmbnbgboacaa
agahaEadabbpatabadatabababadabatabadbqatababadacacabaa
agahaiabbrbsaubtabaububvbwabbxaubyabbzaubAbBabaaaaaaaa
agahaiacbCauaubDbEbFauaubGabauauauabbHauaubDacaaaaaaaa
agahaiabbIbIbIbIabbJbKbLbMabbNbObPabbQbRbSbTabaaaaaaaa
aaababababacacabababacacabababacabababacacababaaaaaaaa
"}
