"aa" = (/turf/template_noop,/area/template_noop)
"ab" = (/turf/closed/wall/r_wall{baseturf = /turf/open/floor/plating/asteroid/basalt/lava_land_surface},/area/mine/bravo)
"ac" = (/obj/machinery/computer/rdconsole,/turf/open/floor/plasteel/terror/necro/warning,/area/mine/bravo)
"ad" = (/obj/machinery/r_n_d/destructive_analyzer,/obj/structure/sign/poster{desc = "A large piece of space-resistant printed paper. A poster encouraging you to work for your future - but what it is, no one is really sure."; icon_state = "poster17_legit"; name = "poster - Work for a Future"; pixel_y = 32; tag = "icon-poster17_legit"},/obj/machinery/light{dir = 1},/turf/open/floor/plasteel/terror/necro/warning,/area/mine/bravo)
"ae" = (/obj/machinery/chem_dispenser/constructable,/turf/open/floor/plasteel/terror/necro/warning{tag = "icon-warning (SOUTHEAST)"; icon_state = "warning"; dir = 6},/area/mine/bravo)
"af" = (/obj/structure/closet,/obj/item/stack/cable_coil,/obj/item/stack/cable_coil,/turf/open/floor/plasteel/terror/necro/whitebot,/area/mine/bravo)
"ag" = (/obj/structure/closet,/obj/item/weapon/storage/box/lights,/obj/item/weapon/storage/box/lights,/turf/open/floor/plasteel/terror/necro/whitebot,/area/mine/bravo)
"ah" = (/obj/structure/chair/stool,/obj/structure/extinguisher_cabinet{pixel_x = -27; pixel_y = 0},/turf/open/floor/plasteel/terror/necro/warnwhite{tag = "icon-warnwhite (NORTHWEST)"; icon_state = "warnwhite"; dir = 9},/area/mine/bravo)
"ai" = (/turf/open/floor/plasteel/terror/necro/warnwhite{tag = "icon-warnwhite (NORTH)"; icon_state = "warnwhite"; dir = 1},/area/mine/bravo)
"aj" = (/turf/open/floor/plasteel/terror/necro/warnwhite{tag = "icon-warnwhite (NORTHEAST)"; icon_state = "warnwhite"; dir = 5},/area/mine/bravo)
"ak" = (/obj/machinery/atmospherics/components/unary/vent_pump{on = 1},/turf/open/floor/plasteel/terror/necro/whitepurple/side{tag = "icon-whitepurple (NORTHWEST)"; icon_state = "whitepurple"; dir = 9},/area/mine/bravo)
"al" = (/turf/open/floor/plasteel/terror/necro/whitepurple/side{tag = "icon-whitepurple (NORTHEAST)"; icon_state = "whitepurple"; dir = 5},/area/mine/bravo)
"am" = (/obj/structure/table/reinforced,/obj/item/weapon/storage/box/beakers,/turf/open/floor/plasteel/terror/necro/warnwhite{tag = "icon-warnwhite (WEST)"; icon_state = "warnwhite"; dir = 8},/area/mine/bravo)
"an" = (/turf/open/floor/plasteel/terror/necro/warnwhite{tag = "icon-warnwhite (SOUTHWEST)"; icon_state = "warnwhite"; dir = 10},/area/mine/bravo)
"ao" = (/turf/open/floor/plasteel/terror/necro/warnwhite,/area/mine/bravo)
"ap" = (/turf/open/floor/plasteel/terror/necro/warnwhite{tag = "icon-warnwhite (SOUTHEAST)"; icon_state = "warnwhite"; dir = 6},/area/mine/bravo)
"aq" = (/obj/machinery/atmospherics/pipe/simple/supply/hidden,/turf/open/floor/plasteel/terror/necro/whitepurple/side{tag = "icon-whitepurple (SOUTHWEST)"; icon_state = "whitepurple"; dir = 10},/area/mine/bravo)
"ar" = (/turf/open/floor/plasteel/terror/necro/whitepurple/side{tag = "icon-whitepurple (SOUTHEAST)"; icon_state = "whitepurple"; dir = 6},/area/mine/bravo)
"as" = (/obj/structure/table/reinforced,/obj/machinery/cell_charger,/obj/item/weapon/stock_parts/cell/high{charge = 100; maxcharge = 15000},/obj/machinery/light{tag = "icon-tube1 (EAST)"; icon_state = "tube1"; dir = 4},/turf/open/floor/plasteel/terror/necro/warnwhite{tag = "icon-warnwhite (WEST)"; icon_state = "warnwhite"; dir = 8},/area/mine/bravo)
"at" = (/obj/machinery/r_n_d/circuit_imprinter,/turf/open/floor/plasteel/terror/necro/warning{tag = "icon-warning (NORTH)"; icon_state = "warning"; dir = 1},/area/mine/bravo)
"au" = (/obj/machinery/r_n_d/protolathe,/turf/open/floor/plasteel/terror/necro/warning{tag = "icon-warning (NORTH)"; icon_state = "warning"; dir = 1},/area/mine/bravo)
"av" = (/obj/machinery/autolathe,/turf/open/floor/plasteel/terror/necro/warning{tag = "icon-warning (NORTHEAST)"; icon_state = "warning"; dir = 5},/area/mine/bravo)
"aw" = (/obj/structure/closet/crate/bin,/obj/machinery/atmospherics/pipe/simple/supply/hidden,/turf/open/floor/plasteel/terror/necro/whitebot,/area/mine/bravo)
"ax" = (/turf/open/floor/plasteel/terror/necro/stairs/top{tag = "icon-ramptop (NORTH)"; icon_state = "ramptop"; dir = 1},/area/mine/bravo)
"ay" = (/obj/machinery/r_n_d/server,/turf/open/floor/plasteel/terror/necro/warnwhite{tag = "icon-warnwhite (WEST)"; icon_state = "warnwhite"; dir = 8},/area/mine/bravo)
"az" = (/obj/effect/spawner/structure/window/reinforced,/turf/open/floor/plating/lavaland,/area/mine/bravo)
"aA" = (/obj/effect/spawner/structure/window/reinforced,/obj/machinery/atmospherics/pipe/simple/supply/hidden,/turf/open/floor/plating/lavaland,/area/mine/bravo)
"aB" = (/obj/machinery/door/airlock/glass_research{name = "RnD"},/turf/open/floor/plasteel/terror/necro/warnwhite/side{tag = "icon-white_warn_side (EAST)"; icon_state = "white_warn_side"; dir = 4},/area/mine/bravo)
"aC" = (/turf/closed/wall{baseturf = /turf/open/floor/plating/asteroid/basalt/lava_land_surface},/area/mine/bravo)
"aD" = (/obj/machinery/light/small{dir = 1},/turf/open/floor/plasteel/terror/necro/darkvault{tag = "icon-vault (NORTHWEST)"; icon_state = "vault"; dir = 9},/area/mine/bravo)
"aE" = (/obj/machinery/mineral/ore_redemption{input_dir = 8; output_dir = 2; req_access = list(0)},/obj/structure/sign/poster{desc = "A large piece of space-resistant printed paper. A poster instructing the viewer to report suspicious activity to the security force."; icon_state = "poster21_legit"; name = "poster - Report"; pixel_y = 31; tag = "icon-poster21_legit"},/turf/open/floor/plasteel/darkvault{dir = 8},/area/mine/bravo)
"aF" = (/obj/machinery/shower{pixel_y = 28},/obj/structure/fans/tiny/invisible,/turf/open/floor/plasteel/terror/necro/darkvault{tag = "icon-vault (WEST)"; icon_state = "vault"; dir = 8},/area/mine/bravo)
"aG" = (/obj/machinery/shower{pixel_y = 28},/turf/open/floor/plasteel/terror/necro/darkvault{tag = "icon-vault (WEST)"; icon_state = "vault"; dir = 8},/area/mine/bravo)
"aH" = (/turf/open/floor/plasteel/terror/necro/warning{tag = "icon-warning (NORTHWEST)"; icon_state = "warning"; dir = 9},/area/mine/bravo)
"aI" = (/obj/machinery/atmospherics/pipe/simple/supply/hidden{dir = 5},/turf/open/floor/plasteel/terror/necro/warning{tag = "icon-warning (NORTH)"; icon_state = "warning"; dir = 1},/area/mine/bravo)
"aJ" = (/obj/machinery/atmospherics/pipe/simple/supply/hidden{dir = 10},/turf/open/floor/plasteel/terror/necro/warning{tag = "icon-warning (NORTH)"; icon_state = "warning"; dir = 1},/area/mine/bravo)
"aK" = (/turf/open/floor/plasteel/terror/necro/warning{tag = "icon-warning (NORTHEAST)"; icon_state = "warning"; dir = 5},/area/mine/bravo)
"aL" = (/obj/machinery/door/airlock/glass_mining{name = "Point-grinder"; req_access_txt = "0"; req_one_access_txt = "6;48"},/turf/open/floor/plasteel/terror/necro/darkwarning/side,/area/mine/bravo)
"aM" = (/turf/open/floor/plasteel/terror/necro/blackvault{tag = "icon-vault (NORTH)"; icon_state = "vault"; dir = 1},/area/mine/bravo)
"aN" = (/turf/open/floor/plasteel/darkvault{dir = 8},/area/mine/bravo)
"aO" = (/obj/machinery/door/airlock/glass_external{name = "Mining External Airlock"; req_access_txt = "54"},/turf/open/floor/plasteel/terror/necro/darkwarning/side,/area/mine/bravo)
"aP" = (/obj/structure/fans/tiny/invisible,/turf/open/floor/plasteel/terror/necro/darkvault{icon = 'icons/turf/infinity.dmi'; icon_state = "darkdelivery"},/area/mine/bravo)
"aQ" = (/turf/open/floor/plasteel/terror/necro/darkvault{icon = 'icons/turf/infinity.dmi'; icon_state = "darkdelivery"},/area/mine/bravo)
"aR" = (/turf/open/floor/plasteel/terror/necro/warning{tag = "icon-warning (WEST)"; icon_state = "warning"; dir = 8},/area/mine/bravo)
"aS" = (/obj/machinery/atmospherics/components/unary/vent_pump{dir = 4; on = 1},/turf/open/floor/plasteel/terror/necro/neutral,/area/mine/bravo)
"aT" = (/obj/machinery/atmospherics/pipe/manifold/supply/hidden,/turf/open/floor/plasteel/terror/necro/neutral,/area/mine/bravo)
"aU" = (/obj/machinery/atmospherics/pipe/simple/supply/hidden{dir = 10},/obj/structure/sink{dir = 4; pixel_x = 11},/turf/open/floor/plasteel/terror/necro/warning{tag = "icon-warning (EAST)"; icon_state = "warning"; dir = 4},/area/mine/bravo)
"aV" = (/obj/item/device/gps/computer{density = 0; gpstag = "BASE BRAVO"; icon_state = "null"; name = "mining base bravo"},/turf/closed/wall/r_wall{baseturf = /turf/open/floor/plating/asteroid/basalt/lava_land_surface},/area/mine/bravo)
"aW" = (/obj/structure/sign/poster{icon_state = "poster19_legit"; pixel_y = -31; tag = "icon-poster19_legit"},/obj/structure/fans/tiny/invisible,/obj/machinery/light/small,/turf/open/floor/plasteel/terror/necro/darkvault{tag = "icon-vault (WEST)"; icon_state = "vault"; dir = 8},/area/mine/bravo)
"aX" = (/obj/machinery/vending/wallmed/regular{pixel_y = -30},/turf/open/floor/plasteel/terror/necro/darkvault{tag = "icon-vault (WEST)"; icon_state = "vault"; dir = 8},/area/mine/bravo)
"aY" = (/turf/open/floor/plasteel/terror/necro/warning{tag = "icon-warning (SOUTHWEST)"; icon_state = "warning"; dir = 10},/area/mine/bravo)
"aZ" = (/turf/open/floor/plasteel/terror/necro/warning,/area/mine/bravo)
"ba" = (/obj/machinery/atmospherics/pipe/simple/supply/hidden,/obj/machinery/power/apc{dir = 4; name = "Post Bravo's APC"; pixel_x = 26; pixel_y = 0},/obj/structure/cable{icon_state = "0-2"; pixel_y = 1; d2 = 2},/turf/open/floor/plasteel/terror/necro/warning{tag = "icon-warning (SOUTHEAST)"; icon_state = "warning"; dir = 6},/area/mine/bravo)
"bb" = (/obj/machinery/sleeper,/turf/open/floor/plasteel/terror/necro/whitebot,/area/mine/bravo)
"bc" = (/obj/structure/closet/crate/freezer/blood,/turf/open/floor/plasteel/terror/necro/whiteblue,/area/mine/bravo)
"bd" = (/obj/machinery/vending/medical{req_access_txt = "0"},/turf/open/floor/plasteel/terror/necro/whiteblue,/area/mine/bravo)
"be" = (/obj/machinery/light{icon_state = "tube1"; dir = 8},/obj/machinery/vending/coffee,/turf/open/floor/plasteel/terror/necro/bot,/area/mine/bravo)
"bf" = (/turf/open/floor/plasteel/terror/necro/brown{tag = "icon-brown (NORTHWEST)"; icon_state = "brown"; dir = 9},/area/mine/bravo)
"bg" = (/turf/open/floor/plasteel/terror/necro/brown{tag = "icon-brown (NORTH)"; icon_state = "brown"; dir = 1},/area/mine/bravo)
"bh" = (/obj/structure/cable{d1 = 1; d2 = 2; icon_state = "1-2"},/obj/machinery/atmospherics/pipe/manifold/supply/hidden{tag = "icon-manifold (WEST)"; icon_state = "manifold"; dir = 8},/turf/open/floor/plasteel/terror/necro/brown{tag = "icon-brown (NORTHEAST)"; icon_state = "brown"; dir = 5},/area/mine/bravo)
"bi" = (/obj/effect/spawner/structure/window/reinforced,/obj/machinery/atmospherics/pipe/simple/supply/hidden{dir = 4},/turf/open/floor/plating/lavaland,/area/mine/bravo)
"bj" = (/obj/machinery/atmospherics/pipe/simple/supply/hidden{dir = 4},/turf/open/floor/plasteel/terror/necro/warnwhite{tag = "icon-warnwhite (NORTHWEST)"; icon_state = "warnwhite"; dir = 9},/area/mine/bravo)
"bk" = (/obj/machinery/atmospherics/components/unary/vent_pump{dir = 8; on = 1},/turf/open/floor/plasteel/terror/necro/warnwhite{tag = "icon-warnwhite (NORTHEAST)"; icon_state = "warnwhite"; dir = 5},/area/mine/bravo)
"bl" = (/obj/structure/sink{dir = 4; icon_state = "sink"; pixel_x = 11; pixel_y = 0},/obj/structure/mirror{desc = "Mirror mirror on the wall, who is the most robust of them all?"; pixel_x = 28},/turf/open/floor/plasteel/terror/necro/whiteblue/side{tag = "icon-whiteblue (EAST)"; icon_state = "whiteblue"; dir = 4},/area/mine/bravo)
"bm" = (/obj/structure/extinguisher_cabinet{pixel_x = -27; pixel_y = 0},/obj/machinery/mineral/equipment_vendor/terror,/turf/open/floor/plasteel/terror/necro/bot,/area/mine/bravo)
"bn" = (/turf/open/floor/plasteel/terror/necro/brown{tag = "icon-brown (SOUTHWEST)"; icon_state = "brown"; dir = 10},/area/mine/bravo)
"bo" = (/turf/open/floor/plasteel/terror/necro/brown,/area/mine/bravo)
"bp" = (/obj/structure/cable{d1 = 1; d2 = 2; icon_state = "1-2"},/obj/machinery/atmospherics/pipe/simple/supply/hidden,/turf/open/floor/plasteel/terror/necro/brown{tag = "icon-brown (SOUTHEAST)"; icon_state = "brown"; dir = 6},/area/mine/bravo)
"bq" = (/obj/machinery/door/airlock/glass_medical{id_tag = null; name = "Infirmary"; req_access_txt = "0"},/turf/open/floor/plasteel/terror/necro/warnwhite/side,/area/mine/bravo)
"br" = (/obj/structure/table/optable,/obj/structure/sign/poster{icon_state = "poster4_legit"; official = 1; pixel_x = 32; serial_number = 4; tag = "icon-poster4_legit"},/turf/open/floor/plasteel/terror/necro/white,/area/mine/bravo)
"bs" = (/obj/structure/ore_box,/turf/open/floor/plasteel/terror/necro/bot,/area/mine/bravo)
"bt" = (/obj/structure/cable{d1 = 1; d2 = 2; icon_state = "1-2"},/obj/machinery/atmospherics/pipe/simple/supply/hidden,/turf/open/floor/plasteel/terror/necro/delivery,/area/mine/bravo)
"bu" = (/obj/structure/table/reinforced,/obj/item/weapon/retractor,/obj/item/weapon/hemostat,/obj/item/weapon/surgical_drapes,/obj/structure/sign/nosmoking_2{pixel_x = -32},/turf/open/floor/plasteel/terror/necro/warnwhite{tag = "icon-warnwhite (NORTH)"; icon_state = "warnwhite"; dir = 1},/area/mine/bravo)
"bv" = (/obj/structure/table/reinforced,/obj/item/weapon/circular_saw,/obj/item/weapon/scalpel,/obj/item/weapon/cautery{pixel_x = 4},/obj/machinery/light,/obj/structure/extinguisher_cabinet{pixel_x = -5; pixel_y = -30},/turf/open/floor/plasteel/terror/necro/warnwhite{tag = "icon-warnwhite (NORTH)"; icon_state = "warnwhite"; dir = 1},/area/mine/bravo)
"bw" = (/obj/machinery/computer/operating,/turf/open/floor/plasteel/terror/necro/warnwhite{tag = "icon-warnwhite (NORTH)"; icon_state = "warnwhite"; dir = 1},/area/mine/bravo)
"bx" = (/obj/structure/cable{d1 = 1; d2 = 2; icon_state = "1-2"},/obj/machinery/atmospherics/pipe/simple/supply/hidden,/obj/machinery/door/airlock/maintenance{name = "Mining Station Maintenance"; req_access_txt = "48"},/turf/open/floor/plating/lavaland,/area/mine/bravo)
"by" = (/obj/structure/reagent_dispensers/fueltank,/obj/structure/sign/nosmoking_2{pixel_x = -32},/turf/open/floor/plating/lavaland,/area/mine/bravo)
"bz" = (/obj/machinery/atmospherics/pipe/simple/supply/hidden{dir = 5},/obj/structure/cable{d1 = 1; d2 = 2; icon_state = "1-2"},/turf/open/floor/plating/lavaland,/area/mine/bravo)
"bA" = (/obj/machinery/atmospherics/components/unary/tank/air{dir = 8},/obj/structure/sign/radiation{pixel_x = 32},/turf/open/floor/plating/lavaland,/area/mine/bravo)
"bB" = (/obj/structure/cable{icon_state = "0-2"; pixel_y = 1; d2 = 2},/obj/machinery/power/rtg/advanced,/turf/open/floor/plating/lavaland,/area/mine/bravo)
"bC" = (/obj/structure/reagent_dispensers/watertank,/turf/open/floor/plating/lavaland,/area/mine/bravo)
"bD" = (/obj/machinery/light/small,/obj/structure/sign/poster{icon_state = "poster18"; pixel_y = -32; serial_number = 18; tag = "icon-poster18"},/obj/structure/cable{d1 = 1; d2 = 4; icon_state = "1-4"; tag = ""},/turf/open/floor/plating/lavaland,/area/mine/bravo)
"bE" = (/obj/structure/cable{tag = "icon-4-8"; icon_state = "4-8"},/turf/open/floor/plating/lavaland,/area/mine/bravo)
"bF" = (/obj/structure/cable{tag = "icon-4-8"; icon_state = "4-8"},/obj/machinery/door/airlock/highsecurity{name = "Radioisotope Thermoelectric Generator"},/turf/open/floor/plating/lavaland,/area/mine/bravo)
"bG" = (/obj/structure/cable{d1 = 1; d2 = 8; icon_state = "1-8"},/obj/machinery/light/small,/turf/open/floor/plating/lavaland,/area/mine/bravo)

(1,1,1) = {"
aaabababababababaaaaaaaaaa
aaabacadaeafagababaaaaaaaa
aaabahaiajakalamabaaaaaaaa
aaabanaoapaqarasabaaaaaaaa
aaabatauavawaxayababababaa
ababababazaAaBaCabaDaEabaa
azaFaGazaHaIaJaKaLaMaNabaa
aOaPaQaOaRaSaTaUabaVababab
azaWaXazaYaZaZbaaCbbbcbdab
ababababbebfbgbhbibjbkblab
aaaaaaabbmbnbobpbqanapbrab
aaaaaaababbsbsbtaCbubvbwab
aaaaaaaaababaCbxaCabababab
aaaaaaaaaaabbybzbAabbBabaa
aaaaaaaaaaabbCbDbEbFbGabaa
aaaaaaaaaaabababababababaa
"}
